EEOC	Equal Employment Opportunity Commission
GIRL	Guy in real life
RNA	Ribonucleic acid
NS	Nice score
PL8	Plate
ECA	Economic Commission for Africa
COB	Close of business
RSN	Real soon now
ASAP	As soon as possible
RYO	Roll your own
PO	Post office
JT (J/T)	Just teasing
TANK	really strong
DC	District of Columbia
PWN	own
TILIS	Tell it like it is
2MOR	Tomorrow
NFWS	Not for work safe
NCCB	National Council of Catholic Bishops
IMNSHO	In my not so humble opinion
AAA	Americans Against Abortion
WHATEVES	Whatever
UNOMOZ	United Nations Operation in Mozambique
URH	You are hot (U R Hot)
IG	Instagram
DILLIGAS	Do I look like I give a sugar?
IMTM	I am the man
IGA	International Gay Association
TTUL	Talk to you later
DOT	Damage over time
CEDPA	Centre for Development and Population Activities
BBT	Be back tomorrow
WH5	Who, what, when, where, why
LRF	Luteinizing releasing factor
NOAPP	National Organization on Adolescent Pregnancy and Parenting
G	Grin
UKTR	You know that's right
OM	Oh, my
USMC	United States Marine Corps
ITAM	It's The Accounting, Man (financial blogs)
ABT	About
OM	Old man
NSA	No strings attached
MCHR	Medical Committee for Human Rights
AGI	agility
WOW	World of Warcraft
FCA	Fellowship of Christian Athletes
RU	Are you?
AAFP	American Academy of Family Physicians
WIC	Women's International Conference
NWCL	National Women's Coalition for Life
VN	Very nice
CWOT	Complete waste of time
CPFH	Center for Population and Family Health, Columbia University
PLAN	Protect Life in All Nations
DNR	Do not resuscitate
UNDOF	United Nations Disengagement Observer Force
MIRL	Me in real life
CPGAF	Committee on Population Growth and the American Family
IAO	I am out (of here)
AG	Andean Group
ABS	American Bible Society
DYOR	Do your own research (common stock market chat slang)
UDI	Unidentified drinking injury (meaning bruise, scratch, ache and so on)
LOL	Laugh out loud
ALMA	Adoptee's Liberty Movement Association
CTHU	Cracking the *heck* up
MKAY	Mmm, okay
YBIC	Your brother in Christ
ARMS	Abortion-Related Ministries
AI	Artificial intelligence
S2R	Send to receive (meaning send me your picture to get mine)
HUYA	Head up your *butt*
LYLAS	Love you like a sis
VBL	Visible bra line
PPFC	Planned Parenthood Federation of Canada
NOEL	National Organization of Episcopalians for Life
NFL	National Federation for Life
CD9	Code 9, Meaning parents are around
MPA	Master of Public Administration
UNCRTN	Uncertain
LC	Library of Congress
LGH	Lets get high
RTL	Right to Life
NSF	National Science Foundation
SYL	Spartacus Youth League
WTO	World Tourism Organization
NBFO	National Black Feminists Organization
MWA	Modern Woodmen of America
NORD	National Organization for Rare Disorders
TBH	To be honest
BIBO	Beer in, beer out
SJD	Doctor of Juridical Science
NIC	Newly industrializing country
PC	Personal computer
QALY	Quality adjusted life years
LTOT	Low tube ovum transfer
NRLC	National Right to Life Committee
TEGWAR	The exciting game without any rules
R	[Degrees] Rankin
NCA	National Chastity Association
EFTA	European Free Trade Association
RGC	Repository for Germinal Choice
NN	Nicaraguan Network
PRC	Population Resource Center
ThD	Doctor of Theology
LWV	League of Women Voters
EIFT	Embryo intrafallopian transfer
S2S	Sorry to say
NIGI	Now I get it
OCA	Orthodox Church of America
WUZ	was
ERIS	Exoatmospheric Reentry Intercept System
KEYA	I will key you later
IANAC	I am not a crook
QOL	Quality of life
UFN	Until further notice
FRI	Family Research Institute
FML	*Freak* My Life
CWOT	Complete waste of time
NFS	Not for sale
CFY	Calling for you
IF	I farted
WAN2TLK	Want to talk
RT	Retweet (Twitter slang)
M$	Microsoft
FRG	Federal Republic of Germany
WTO	World Tourism Organization
RRN	Reproductive Rights Network
MSG	Message
DGYF	Dang, girl you fine
OMDB	Over my dead body
LYLC	Love you like crazy
NIE	National Institute for Education
APTN	American Public Television Network
Cakeday	Birthday (Reddit)
2B	To be
DC	District of Columbia
AWOL	Away without leaving
BWS	Better World Society
HLS	Human Life Statute
BYOD	Bring your own device
OVA	Over
ThD	Doctor of Theology
HBU	How about you?
WOMB	Women Opposed to Massacre and Brutality
OPANAL	Organismo para la Proscripcion de las Armas Nucleares en la 
JV	Joint venture
NRC	National Research Council
NIFOC	Naked in front of computer
MEGO	My eyes glaze over
TCOY	Take care of yourself
10M	Ten man
F2F	Face to face
6Y	Sexy
JP	Jackpot (online gaming, bingo games)
OAU	Organization of African Unity
TANSTAAFL	There ain't no such thing as a free lunch
WARN	Women of All Red Nations
QQ	Quick question
NGO	Non-governmental organization
X!	a typical woman
CUT	Church Universal and Triumphant
EEC	European Economic Community
NCLR	National Center for Lesbian Rights
TRUTH	Teens Rescuing Unborn Tiny Humans
OTFL	On the floor laughing
PLZ	Please
UF	You farted
V	Very
NCGO	National Coalition of Gay Organizations
AA	Ask about
O	hugs
SK8NG	Skating
MEH	a shrug or shrugging shoulders
PID	Pelvic inflammatory disease
G	Grand
JV	Joint venture
NWO	No way out
PKU	Phenylketonuria
LOTR	Lord of The Rings
ABTA	Good-bye (signoff)
CCC	Customs Cooperation Council
AOH	Ancient Order of Hibernians
OOTO	Out of the office
2B	To be
D46?	Down for sex?
HLC	Human Life Center
AFE	Americans for the Environment
DXNRY	Dictionary
JP	Just playing 
IEA	International Energy Agency
USSR/EE	USSR/Eastern Europe
MS	Multiple sclerosis
SF	Someone farted
TLC	Teen Line Connection
GNIGHT	Good night
FYA	For your amusement
BM	Bite me
SBC	School-based clinic
PTO	Parent Teacher Organization
SIHTH	Stupidity is hard to take
KMK	Kiss my keister
BS	Bachelor of Science
CCAR	Central Conference of American Rabbis
E1	Everyone
NHANES	National Health and Nutrition Examination Survey
HL	House of Lords
STM	Sacrae theologiae masterieus
OOH	Out of here
UX	User experience
UCMU	You crack me up
TIAD	Tomorrow is another day
WAREZ	pirated (illegally gained) software
TTET	Transvaginal-transmyometrial embryo transfer
SUX	Meanings sucks or it sucks
TSD	Tay-Sachs Disease
CLW	Council for a Livable World
HL	Half Life
CRB	Come right back
TC	Transcervical
DGT	Don't go there
2EZ	Too easy
GG	Brother (Mandarin Chinese txt msgs)
GALA	Gay and Lesbian Alliance
PAT	patrol
AGI	agility
AWESO	Awesome
NLFO	National Lesbian Feminist Organization
GTM	Giggling to myself
ACC	Anyone can come
19	Zero hand
ABEDA	Arab Bank for Economic Development in Africa
RIP	Requiescat in pace
UNAVEM	United Nations Angola Verification Mission
kB	Kilobyte
POPTECH	Population Technical Assistance Project
RC	Roman Catholic
1TG, 2TG	number of items needed for win
CHK	Check
LSHMBH	Laugh so hard my belly hurts
KK	Okay, Okay!
FUD	Face up deal
GOA	Government Accounting Office
IIE	Institute of International Education
WYGAM	When you get a minute
NAWL	National Association of Women Lawyers
AAS	Abortion Abolition Society
G2CU	Good to see you
FCC	Freedom of Choice Coalition
FIMH	Forever in my heart
TEF	The Environmental Fund
NAGAP	National Association of Gay Alcoholism Professionals
RICO	Racketeering-Influenced Corrupt Organizations Act
FF	Follow Friday (Twitter slang)
WAJ	What a jerk
MR.(number)	child and his age. Mr.3 would be a 3-year old son
AD	Anno Domini
OECD	Organization for Economic Cooperation and Development
WTGP	Want to go private (talk out of public chat area)
PCI	Pax Christi International
B/G	Background (personal information request)
CNF	Conservation Network Foundation
SPC	South Pacific Commission
FACES	National Association for the Craniofacially Handicapped
WAJ	What a jerk
CEPGL	Communaute Economique des Pays des Grands Lacs
FCF	Free Congress Foundation
EGF	Epidermal growth factor
LOTI	Laughing on the inside
PPPPPPP	Proper prior planning prevents putrid poor performance
HP	Hit points / Health points
OB	Oh baby
L2P	Learn to play
OMFG	Oh my *freaking* God
CMB	Call me back
WTFE	What the *freak* ever
ECMO	Extracorporeal membrane oxygenation
LAV	Lymphadenopathy Virus
GFI	Go for it
OHHEMMGEE	Oh My God (alternate of OMG)
SWAG	Scientific wild *a* guess
URC	University Research Corporation
ILO	International Labor Organization
SNAFU	Situation normal
FPWA	Federation of Protestant Welfare Agencies
PO	Post office
IAWS	Intercollegiate Association of Women Students
CYAL8R	See you later
ALD	Adrenoleukodystrophy
NSFW	Not safe for work
ASLM	American Society of Law and Medicine
IHNI	I have no idea
?	I don't understand what you mean
KDFU	Means Cracking (K) the (D as in Da) *freak* up
AEAP	As early as possible
GLE1	Good luck everyone
MP	Mana points
UFWM	You *freaking* with me?
EAK	Eating at keyboard
SRA	Science Research Associates
MU	Miss U (you)
ICJ	International Court of Justice
2NTE	Tonight
SWS	Sociologists for Women in Society
NSCE	National Center for Science Education
LYLC	Love you like crazy
AOC	Available on cell
AARP	American Association of Retired Persons
FWB	Friend with benefits
NRLC	National Right to Life Committee
P.R.	Public relations
BL	Belly laugh
ADA	Adenosine deaminase
IMF	International Monetary Fund
UKTR	You know that's right
SMSA	Standard Metropolitan Statistical Area
RX	drugs or prescriptions
HD	Huntington's disease
WYCM	Will you call me?
QFE	Question for everyone
RD	Rural delivery
THX	Thanks
ST&D	Stop texting and drive
SMHID	Scratching my head in disbelief
AZN	Asian
CLRCR	Catholic League for Religious and Civil Rights
MCCL	Minnesota Citizens Concerned for Life
DHHS	Department of Health and Human Services
GRATZ	Congratulations
B8	Bait (person teased or joked with, or under-aged person/teen)
AASK	Aid to Adoption of Special Kids
AG	Attorney general
TFR	Total fertility rate
SUP	What's up?
CBE	Center for Biomedical Ethics
CTSA	Catholic Theological Society of America
IYSS	If you say so
ALA	American Library Association
C	Commonwealth
X-1-10	Exciting
COYOTE	Cast Off Your Old Tired Ethics
JC (J/C)	Just checking
YGTR	You got that right
HAU	How about you?
@TEOTD	At the end of the day
XLR8	faster or going faster
FOE	Fraternal Order of Eagles
C4N	Ciao for now
NASSP	National Association of Secondary School Principals
LSMT	Life-sustaining medical treatment
IVIG	Intravenous immunoglobulin
GL/HF	Good luck, have fun 
HCFA	Health Care Financing Administration
NSG	Nuclear Suppliers Group
ACP	African, Caribbean, and Pacific Countries
ENUF	Enough
AHEA	American Home Economics Association
CFY	Calling for you
UUA	Unitarian Universalist Association
BCFA	Birth Control Federation of America
IAE	In any event
JSD	Doctor of Juristic Science
CPA	Center for Policy Alternatives
VEG	Very evil grin
Y2K	You're too kind
CN-M	Certified nurse-midwife
2MOR	Tomorrow
WOA	Work of Art
KOTL	Kiss on the lips
STM	Sympto-thermal method
PND	Prenatal diagnosis
EC	Evangelicals Concerned
AFL-CIO	American Federation of Labor and Congress of Industrial Organizations
URH	You are hot (U R Hot)
BSF	But seriously folks
E	Enemy
AAF	As a friend
TFTI	Thanks for the invitation
IRMC	I rest my case
ZDV	Zidovudine
NWLC	National Women's Law Center
IGN	I (I've) got nothing
AID	[United States] Agency for International Development
MPS	Mucopolysaccharidoses
AA	As above
PWN	own
SAT	Sorry about that
BOLO	Be on the look out
OGIM	Oh God, it's Monday
CHAMPUS	Civilian Health and Medical Program of the Uniformed Services
VOGUE	Valiant Out Gays United in Energy
BIOYA	Blow it out your *a*
COR	Coalition on Revival
DITYID	Did I tell you I'm distressed?
411	information
MAD	Mutual assured destruction
AYBABTU	All your base are belong to us
JELLY	jealous
JD	Juris Doctor
SH^	Shut up
NAM	New American Movement
START	Strategic arms reduction treaty
S&M	Sado-masochism
MAR	Mixed antiglobulin reaction
TNT	Til next time
PLAN	Plan Loving Adoption Now
BID	Banco Interamericano de Desarrollo
DF	Don't fart
P-FLAG	Parents and Friends of Lesbians and Gays
MNC	Mother nature calls
GRATZ	Congratulations
APAC	All praise and credit
PRM	Physicians for Moral Responsibility
SWL	Screaming with laughter
F	female
NSFG	National Survey of Family Growth
MYOB	Mind your own business
Feelsbadman	A social meme that means to feel negative.
HD	Huntington's disease
1432	I love you too
DTS	Don't think so
UTM	You tell me
OP	Optimum Population, Inc.
ITYK	I thought you knew
KOW	Knock on wood
SAL	Such a laugh
NCI	National Cancer Institute
XD	really hard laugh (where D is a smiley mouth)
0.02	My (or your) two cents worth
O	Over
EI	Eosinophilic index
EOD	End of day
CTO	Check this out
CALM	Custody Action for Lesbian Mothers
TMTH	Too much to handle
2N8	Tonight
LDL	Low-density lipoprotein
Y2K	You're too kind
QC	Quality control
NN	Nicaraguan Network
<3	sideways heart (love, friendship)
HM	His or Her Majesty
CCREF	Conservative Caucus Research and Education Fund
CID	Consider it done
CJ	Chief Justice
NFS	Not for sale
TANK	really strong
UNTAC	United Nations Transitional Authority in Cambodia
CLC	Clergy and Laity Concerned
UR	You are / You're
IA8	I already ate
GLAD	Gay and Lesbian Awareness Da
BIB	Boss is back
FFA	Free for all
PAT	patrol
PROBS	Probably
VP	Vice President
BIH	Burn in hell
TRUTH	Teens Rescuing Unborn Tiny Humans
KEWL	Cool
EOD	End of discussion
PAS	Post-abortion syndrome
EC	European Community
AITR	Adult in the room
ECE	Economic Commission for Europe
LBVS	Laughing, but very serious
ETA	Estimated time of arrival
TTG	Time to go
ALCON	All concerned
XD	a devilish smile
TIR	Teacher in room
GF	Girl friend
WTG	Way to go
ICJ	International Court of Justice
HAU	How about you?
NAB	National Association of Broadcasters
C/P	Cross post
4NR	Foreigner 
KOL	Kiss on cheek
PDQ	Pretty darn quick
LYLAS	Love you like a sis
14AA41	One for all, and all for one
BIC	Butt in chair
DAFUQ	(What) the *Freak*?
AVDA	American Venereal Disease Association
FAAK	Falling asleep at keyboard
HUB	Head up butt
VRY	Very
CEP	Council on Environmental Quality
PSOS	Parent standing over shoulder
IGAB	Interagency Group for Action on Breastfeeding
NW	No way
SENPAI	someone older than you, someone you look up to
CMON	Come on
KNIM	Know what I mean?
PROST	Pronuclear stage tubal transfer
EM	E-mail (Twitter slang)
WTF	What the *freak* ?
EE2	Ethinyl estradiol
WBU	What about you?
WFP	Witness for Peace
GAS	Gay Alliance of Students
BBN	Bye, bye now
ADD	Address
4COL	For crying out loud
WAN2	Want to? (SMS)
PA	Physicians assistant
ILBL8	I'll be late
LLD	Doctor of Law
ASIG	And so it goes
CP	Congregation of the Passion
OEEC	Organization for European Economic Cooperation
NLT	No later than
B	Back
GCC	Gay Community Center
NIB	Nordic Investment Bank
QED	Quod erat demonstrandum
PS	Postscriptum
BTYCL	Bootycall'
TLK2UL8R	Talk to you later
MSSVD	Medical Society for the Study of Venereal Diseases
PRW	People/parents are watching
CG	Contadora Group
THT	Think happy thoughts
JIC	Just in case
MM	Maryknoll Missioners
VAT	Value added tax
V	Very
EMA	E-mail address (Twitter slang)
L/GHTS	Lesbian and Gay Humanists
ABBR	abbreviation
DIY	Do it yourself
UMC	United Methodist Church
MEZ	mesmerize
NM	Nothing much
LOL	Laughing out loud
WMA	Women's Medical Association
CSG	Chuckle, snicker, grin
EIB	Excellence in Broadcasting [Network]
AVDA	American Venereal Disease Association
FHA	Future Homemakers of America
?	I don't understand what you mean
KISS	Keep it simple, stupid
1UP	extra life
SIFT	Sperm Intrafallopian Transfer
WIBNI	Wouldn't it be nice if
86	Over
STR8	Straight
GALA	Gay and Lesbian Alliance
SBT	Sorry 'bout that
1NAM	One in a million
AI	Amnesty International
NWCL	National Women's Coalition for Life
GGOH	Gotta Get Outa Here
INC	incoming
PRC	People's Republic of China
JLC	Juvenile Law Center
AFS	American Fertility Society
E	Ecstasy
CU2	See you
TTYAFN	Talk to you awhile from now
IWO	Institute for World Order
HLSC	Human Life Statute Coalition
SOMARC	Social Marketing for Change
InCAR	International Committee Against Racism
ASCAP	American Society of Composers, Authors and Publishers
HHIS	Head hanging in shame
DYFM	Dude, you fascinate me
QL	Quit laughing
JW	Just wondering
AFA	American Family Association
MIC	Maternal and Infant Care
SITD	Still in the dark
UNBLEFBLE	Unbelievable
BCO	Big crush on
PEI	Prince Edward Island
HIFW	How I felt when... (Used with photo or gif)
SH^	Shut up
EMFBI	Excuse me for jumping in
ICS	Institute for Creation Spirituality
OPM	Office of Personnel Management
BOT	Be on that
DPS	Damage per second
FBM	Fine by me
WITW	What in the world
WASP	We are Satan's people
POM	Public opinion message
2N8	Tonight
BBT	Be back tomorrow
WHCH	White House Conference on Hunger
TIC	Tongue-in-cheek
HIV-Ag	Human immunodeficiency virus antigen
PRO	Public relations officer
UGTBK	You've got to be kidding
BCNU	Be seeing you
RIP	Rest in peace
WASP	We Are Sexual Perverts
GOA	Government Accounting Office
55555	Laughing (In Thai language the number 5 is pronounced 'ha'.)
NOYB	None of your business
WYLEI	When you least expect it
ISIS	Institute for the Scientific Investigation of Sexuality
PDQ	Pretty darn quick
LOOM	Loyal Order of Moose
PTA	Parent-Teacher Association
CYEP	Close your eyes partner
VIP	Very important person
YAF	Young America Foundation
P	Partner
WRU	Where are you?
OTTOMH	Off the top of my head
ROTFLUTS	Rolling on the floor laughing unable to speak
OT	Ovum transfer
ALA	American Library Association
AA	Alcoholics Anonymous
SWAT	Scientific wild *butt* guess
BAY	Back at ya
APCW	Adolescent Pregnancy Childwatch Project
MOMBOY	Mamma's boy
Y	Yawn
UNIKOM	United Nations Iraq-Kuwait Observation Mission
TANKING	owning
CU	Consumer's Union
ADBB	All done, bye-bye
HB	Hug back
ABM	Anti-ballistic missile
DILLIGAF	Do I look like I give a *freak*?
L2K	Like to come
CHAMPVA	Civilian Health and Medical Program of the Veterans Administration
AANFP	American Academy of Natural Family Planning
LLB	Bachelor of Law
BOHICA	Bend over here it comes again
B9	Boss is watching
RX	drugs or prescriptions
QQ	Quick question
SAMA	Student American Medical Association
UF	You farted
ALC	American Lutheran Church
PTO	Paid time off
IH2F	I have to fart
WHAM	Women's Health Action Mobilization
AMEND	Moms Experiencing Neonatal Death
10M	Ten man
IVH	Intraventricular hemorrhage
NAM	New age movement
FISH	First in, still here
AISI	As I see it
CURE	Citizens United Resisting Euthanasia
TALL	Teen American Life League
B2B	Business-to-business
IWIAM	Idiot wrapped in a moron
LULZ	joke, or for laughs
BIRTH	Born Individuals Rescuing the Helpless
KB	Kick butt
NHLA	National Hispanic Lawyers Association
10X	Thanks
CM	Call me
AED	Academy for Educational Development
S-T	Sympto-thermal
FAM	Fertility awareness method
WWNC	Will wonders never cease
UR	You are / You're
CEIP	Carnegie Endowment for National Peace
ICBM	Intercontinental ballistic missile
NCCC	National Council of Catholic Charities
PUKS	Pick up kids (SMS)
UNFAO	United Nations Food and Agricultural Organization
NEN	Norethindrone acetate
FBFR	FaceBook friend
TIA	Thanks in advance
SS	Saints
PFT	Pretty *freaking* tight
PLD	Played
WAH	Working at home
NW	No way
JFF	Just for fun
DEIS	Draft environmental impact statement
FICCL	Frankly I couldn't care a less
XYL	Ex-young lady, meaning wife. (amateur radio) 
FHI	Family Health International
ILU	I love you
AG	Andean Group
CBTV	Coalition for Better Television
STOP	Save the Oppressed People
QT	Cutie
GT	Good try
CAN	Cult Awareness Network
ASLA	Age/sex/location/availability
PA	Prothonotary apostolic
OSF	Order of St. Francis
IDGAF	I don't give a *freak*
LFD	Left for day
PC	Population Communication
GDR	Grinning, ducking, and running
SNERT	Snot nosed egotistical rude teenager
TBA	To be announced
IRC	Interchange Resource Network
PCA	Presbyterian Church in America
NWM	New Ways Ministry
RATS	Radical [AIDS] Activist Truth Squad
IBM	International Business Machine
BBL	Be back later
AAF	As a friend
ICCC	International Concerns Committee for Children
CRAFT	Can't remember a *freaking* thing
WCC	World Council of Churches
UHGTBSM	You have got to be s#$t*ing me!
CGD	Chronic granulomatous disease
ASA	Association for the Study of Abortion
SEM	Scanning electron microscope
AOTA	All of the above
CAD	Short for Canada/Canadian
UKTR	You know that's right
YCDBWYCID	You can't do business when your computer is down
WBS	Write back soon
IDUNNO	I don't know
WE	Whatever
LEMENO	Let me know
FYI	For your information
BASOR	Breathing a sigh of relief
WSP	Women Strike for Peace
SCLC	Southern Christian Leadership Conference
DBAU	Doing business as usual
YTG	You're the greatest
AI	Amnesty International
GGA	Good game, all
PCM	Please call me
PXT	Please explain that
ET	Embryo transfer
S2R	Send to receive (meaning send me your picture to get mine)
FY	Fiscal year
BTA	But then again
PA	Public address
BAFO	Best and final offer
SOS	Son of Sam
G7	Group of Seven
OMW	On my way
DA	The
PIH	Pyridoxal isonicotinoyl hydrazone
TLN	The Lavender Network Magazine
CURE	Citizens United for Responsible Education
CD9	Code 9, Meaning parents are around
AACP	American Academy of Child Psychiatry
DH	Dear (or Darling) husband
H-FDAY	Happy Father's Day
EOD	End of day
CU	See you too
ARL	Americans for Religious Liberty
BFAW	Best friend at work
CERN	Conseil Europeen pour la Recherche Nucleaire
BBS	Be back soon
GD	Good
UCC	United Church of Christ
UNDP	United Nations Development Program
MC	Merry Christmas
DBEYR	Don't believe everything you read
LYSM	Love you so much
APHA	American Protestant Hospital Association
2MORO	Tomorrow
LFD	Left for day
YMMV	Your mileage may vary
AF	As *Freak*
SIG2R	Sorry, I got to run
MD	Medical doctor
CP	Communist Party
UF	You farted
143	I love you
MB	Megabyte
NATO	North Atlantic Treaty Organization
UNICEF	United Nations Children's Emergency Fund
TVC	Traditional Values Coalition
CPA	Certified public accountant
RYS	Read your screen 
182	I hate you
X	Kiss
DDC	Dewey Decimal Classification
HLSC	Human Life Statute Coalition
NT	New Testament
FITB	Fill in the blank
SADC	Southern African Development Community
SK8NG	Skating
H-MDAY	Happy Mother's Day
CHSA	Consumer Health Service of America
ILY	I love you
G2R	Got to run
VGH	Very good hand
ACLU	American Civil Liberties Union
EF4T	Effort
WADB	West African Development Bank
AKA	Also known as
DBP	Defense Budget Project
UFWM	You *freaking* with me?
TAM	Tomorro a.m.
AFAM	Ancient Free and Accepted Masons
SKAT	Sex Knowledge and Attitude Test
JC (J/C)	Just checking
STD	Sacrae theologiae doctor
PPD	Post-partum depression
POC	Prisoners of conscience
NAC	Network Action Committee
YF	Wife
SLAA	Sex and Love Addicts Anonymous
G/F	Girlfriend
oob	off our backs [Magazine]
PLEA	Pro-Life Educational Association
TU	Thank you
OA	Online auctions (see more auction abbreviations)
LH6	Lets have sex
ARF	Animal Rights Front
AAL	American Abolitionist League
FAS	Fetal alcohol syndrome
ICD	Intracervical device
NOLGS	National Organization of Lesbian and Gay Scientists
IAEA	International Atomic Energy Agency
AFAIAA	As far as I am aware
HBU	How about you?
ICAM	I couldn't agree more
CWRR	'Catholic' Women for Reproductive Rights
FFLA	Feminists for Life of America
1CE	Once
OCarm	Order of Carmelites
2MOR	Tomorrow
IWW	Industrial Workers of the World
YT	You there?
NCHLA	National Committee for a Human Life Amendment
AG	Attorney general
C	[Degrees] Celsius
IMO	International Maritime Organization
SK8	Skate
CNS	Committee for National Security
CSER	Committee for the Scientific Examination of Religion
RD	Rural delivery
FSA	Free Speech Advocates
AIHCA	American Indian Health Care Association
NIGI	Now I get it
AIPOP	American Institute of Public Opinion Poll
QL	Quit laughing
1CE	Once
FTFY	Fixed that for you
TTYS	Talk to you soon
RSCJ	Religious of the Sacred Heart of Jesus
URSKTM	You are so kind to me
19	Zero hand
IWO	Institute for World Order
n00b	Newbie
BRD	Bored
SIT	Stay in touch
ESF	Economic support funds
OEO	Office of Economic Opportunity
GRID	Gay-Related Immune Deficiency
BM	Basal metabolism
CD	Congressional district
2M2H	Too much too handle
KEYA	I will key you later
EO	Executive Order
H8TTU	Hate to be you
CM	Congregation for the Mission
LD	Long distance
DV	Douay Version
NIE	National Institute for Education
FBF	Facebook friend
NOPARH	National Office of Post-Abortion Reconciliation and Healing
CM	Call me
NSISR	Not sure if spelled right
S'OK	It' (s) okay (ok)
GN	Good night
TM	Transcendental meditation
LAES	Latin American Economic System
WITCH	Witches' International Conspiracy from Hell
ABOG	American Board of Obstetrics and Gynecology
HW	Homework
STR8	Straight
IH2F	I have to fart
WHO	World Health Organization
SOS	Son of Sam
QTPI	Cutie pie
L2G	(would) Love to go
CIV	Cultures, ideas and values [course]
CU	See you
P2P	Pay to play
PAPP-A	Pregnancy-associated plasma protein-A
CP	Congregation of the Passion
IFCA	International Federation of Catholic Alumnae
UPS	Uterine progesterone system
Feelsgoodman	A social meme that means to feel positive.
AP	Associated Press
SV	Soror Vitae
C4N	Ciao for now
TLN	The Lavender Network Magazine
CHA	Christian Holiness Association
WYD	What (are) you doing?
JAM	Just a minute
GWHTLC	Glad we had this little chat
CYA	See you
CREOG	Council on Resident Education in Obstetrics and Gynecology
PLMK	Please let me know
MGB	May God bless
AA	American Atheists
TAM	Tomorro a.m.
BAK	Back at keyboard
BPLM	Big person little mind
14AA41	One for all, and all for one
Cakeday	Birthday (Reddit)
ME	Menstrual extraction
ONL	Online
VFC	Voters for Choice
TA	Transabdominal
WYGAM	When you get a minute
TIPPS	Technical Information Population for the Private Sector
LY	Love ya 
DSOC	Democratic Socialist Organizing Committee
APO	Army Post Office
USSR	Union of Soviet Socialist Republics
AASECT	American Association of Sex Educators, Counselors and Therapists
NAF	National Abortion Federation
LYSM	Love you so much
VGC	Very good condition
BSOD	Blue screen of death
NGHC	National Gay Health Coalition
IRL	In real life
AZT	Azidothymidine
GRWG	Get right with God
NERF	Changed and is now weaker
PWA	Person
IYKWIM	If you know what I mean
IM	Instant message
PA	Prothonotary apostolic
UF	You farted
PDR	Physicians Desk Reference
KJV	King James Version
DNC	Democratic National Committee
RTRCTV	Retroactive (email, Government)
BM&Y	Between me and you
SCLC	Southern Christian Leadership Conference
GTG	Got to go
ASC	American Security Council
BC	Because
BIOYA	Blow it out your *a*
GAS	Got a second?
DM	Dungeon Master
UPC	United Pro-Life Council
HLC	Human Life Center
4COL	For crying out loud
555	Sobbing, crying. (Mandarin Chinese txt msgs)
APPP	Association of Planned Parenthood Physicians
NRDA	Natural Resources Defense Association
Op	cit Opere citato
IPAS	International Projects Assistance Services
NYPLC	National Youth Pro-Life Coalition
AWOL	Absent without leave
IOC	International Olympic Committee
F	[Degrees] Fahrenheit
UNEP	United Nations Environment Program
EST	Eastern standard time
RUMOF	Are you male or female?
FOE	Friends of the Earth
PSP	Playstation Portable
PROLLY	Probably
BL	Belly laugh
AGS	American Geriatrics Society
TOTS	Tubal ovum transfer of sperm
ICAM	I couldn't agree more
ADN	Any day now
MNSG	Mensaje (message in Spanish)
AHA	American Humanist Association
PLMK	Please let me know
IDC	I don't care
LLD	Doctor of Law
ANZUS	Australia-New Zealand-United States Security Treaty
L2G	(would) Love to go
WRA	Women of reproductive age
DTRT	Do the right thing
CR	Calendar rhythm
FACS	Flourescence-activated cell sorter
2M2H	Too much to handle
UPA	Unwed Parents Anonymous
CMAC	Catholic Marriage Advisory Council
IAE	In any event
SA	Spontaneous abortion
IFC	International Finance Corporation
AYV	Are you vertical?
H.B.	House Bill
AAHA	American Academy of Health Administration
DL	Dead link
SDMB	Sweet dreams, my baby
NADT	Not a darn thing
IMP	Imprimatur
d00d	Dude
UW	You're welcome
NMR	Nuclear magnetic resonance [spectroscopy]
WOA	Work of Art
ACQSTN	Acquisition (e-mail, Government)
WSP	Women Strike for Peace
CG	Contadora Group
OPEN	Organization to Promote Equality Now
NCEA	National Catholic Education Association
MCH	[Department of] Maternal and Child Health
TLC	Teen Line Connection
IOW	In other words
SICNR	Sorry, I could not resist
INV	Invite
BCR	Benefit-cost ratio
LNT	lost in translation
OMGYS	Oh my gosh you suck 
VFF	Very freaking funny
LFG	Looking for guard
AYBABTU	All your base are belong to us
NLG	National Lawyer's Guild
AF	Aggression factor
BF2	Battlefield 2
OOTD	One of these days
ASAT	Anti-satellite weapons
10Q	Thank you
MS	Multiple sclerosis
TIC	Tongue-in-cheek
APPP	Association of Planned Parenthood Physicians
BDEAC	Banque de Developpment des Etats de l'Afrique Centrale
^5	High-five
USBCA	Until something better comes along
RS	Runescape
ACD	ALT / CONTROL / DELETE
EEOC	Equal Employment Opportunity Commission
SPK	Speak (SMS)
DIS	Did I say?
DERP	stupid or silly
GALA	Gay Atheists League of America
4EVA	Forever
AFT	American Federation of Teachers
^5	High-five
AFAM	Ancient Free and Accepted Masons
1TG, 2TG	number of items needed for win
PZA	Pizza
AJC	American Jewish Congress
BD	Bachelor of Divinity
HM	His or Her Majesty
ATM	At the moment
Msgr	Monsignor
SS	Saints
KNIM	Know what I mean?
PP	Planned Parenthood
OECS	Organization of Eastern Caribbean States
C-Span	Congressional Coverage Cable Network
TOT	Tubal ovum transfer
RU	Are you?
QFB	Queers fight back
OTB	Off to bed
XYL	Ex-young lady, meaning wife. (amateur radio) 
ALADI	Asociacion Latinoamericana de Integracion;
TARS	Thrombocytopenia with absent radii syndrome
WUW	What u (you) want?
UT	Unreal Tournament
TSH	Tripping so hard
AFL	Adolescent Family Life
AOE	Area of effect (online game)
PA	Power of attorney
SEM	Scanning electron microscope
AMEND	Moms Experiencing Neonatal Death
CAH	Congenital adrenal hyperplasia
NOPARH	National Office of Post-Abortion Reconciliation and Healing
LIMT	Laugh in my tummy
VITI	Vaginal intratubal insemination
UNA	Use no acronyms
BRBB	Be right back *babe*
OMS	On my soul (meaning promise)
NICHD	National Institute of Child Health and Human Development
KSC	Kind (of) sort (of) chuckle
USGPO	United States Government Printing Office
NANN	National Association of Neonatal Nurses
NTL	National Teens for Life
SACU	Southern African Customs Union
SOT	Short of time
GIFT	Gamete intra-fallopian transfer
FACES	National Association for the Craniofacially Handicapped
TMA	Take my advice
KIA	Know it all
GLAAD	Gay and Lesbian Alliance Against Defamation
NTD	Neural tube defect
SD	#VALUE!
D&E	Dilatation and evacuation
l33t	Leet, meaning 'elite'
PCS	Population Communication Services, Johns Hopkins University
P911	Parents coming into room alert
NCCW	National Council of Catholic Women
BRNC	Be right back, nature calls
oob	off our backs [Magazine]
L.A.	Latin America
IH2F	I have to fart
AASECT	American Association of Sex Educators, Counselors and Therapists
EAF	Environmental Action Foundation
ZH	Sleeping Hour
MDIAC	My Dad is a cop
HCS	Human chorionic somatomammotropin
NCHS	National Center for Health Statistics
RH	Rhesus [positive or negative]
DNR	Dinner (SMS)
SAIDS	Simian
BWMT	Black and White Men Together
AOM	Age of majority
DTR	Define the relationship
OMGYG2BK	Oh my God, you got to be kidding
MIA	Missing in action
Abp	Archbishop
XD	really hard laugh (where D is a smiley mouth)
NAAO	National Association of Artist's Organizations
NAAO	National Association of Artist's Organizations
P911	Parents coming into room alert
TYFC	Thank you for charity
AEC	Atomic Energy Commission
UN4TUN8	Unfortunate
L2K	Like to come
EPK&C	Early prenatal karyotype farenand cell scan
ECLA	Economic Commission for Latin America
MRW	My reaction when... (Used with photo or gif)
CAD	Control + Alt + Delete
IK	I know
CM	Calendar method
MCC	Metropolitan Community Church
PPNG	Penicillinase-producing Neisseria gonorrhea
CUMID	See you in my dreams
AFL	Adolescent Family Life
CUA	Catholic University of America
2	to in SMS
PST	Please send tell
LMIRL	Lets meet in real life
WMA	Women's Medical Association
LAES	Latin American Economic System
SM	Social media
FIAMC	International Federation of Catholic Medical Associations
NDA	New drug application
BR	Best regards
Bloke	Man (Discord)
EOT	End of transmission
SDI	Strategic Defense Initiative
TSTB	The sooner, the better
UF	You farted
DHU	Dinosaur hugs (used to show support)
KIT	Keep in touch
OTOH	On the other hand
UPA	Unwed Parents Anonymous
BSEC	Black Sea Economic Cooperation Zone
MCH	[Department of] Maternal and Child Health
SUTH	So use(d) to haters (Facebook)
SRP	Short rib-polydactyly syndrome
RL	Real life
LBS	Laughing, but serious
PIRG	Public Interest Research Group
121	One-to-one (private chat initiation)
EPS	Early Pregnancy Services
Z	Said
CRTI	Center for the Rights of the Terminally Ill
QT	Cutie
JSD	Doctor of Juristic Science
OEA	Office of Environmental Affairs
CPB	Corporation for Public Broadcasting
LLM	Master of Law
NC	Nice crib
AP	Associated Press
CURE	Citizens United Resisting Euthanasia
EI	Eat it
PAPOC	Parents Alliance to Protect Our Children
IWALU	I will always love you
SG	Surgeon General
UNESCO	United Nations Educational, Scientific, and Cultural Organization
USGPO	United States Government Printing Office
IWY	International Women's Year
RTBS	Reason to be single
CDB	Caribbean Development Bank
UTI	Urinary tract infection
UWA	United Way of America
PLS	Please
P.C.	Politically correct
PSS	Peace Science Society
UF	You farted
AOC	Available on cell
AFPOE	A fresh pair of eyes
ABC	American Baby Code
LD50	Lethal Dose 50%
IB	I'm back
INFACT	Infant Formula Coalition
MIM	Morality in Media
UFWM	You *freaking* with me?
AOA	American Orthopsychiatric Association
TFF	Too *freaking* funny
ADA	Americans for Democratic Action
BT	Between technologies
SS	Schutzstaffel
NTS	Note to self
OES	Order of the Eastern Star
BLNT	Better luck next time
NTHING	Nothing (SMS)
BBC	British Broadcasting Corporation
FAA	Foreign Assistance Act
TTLY	Totally
CRASH	Committee Against Racism, Sexism, and Heterosexism
AVC	American Veterans Committee
TL;DR	Too long; didn't read
WAYF	Where are you from?
TARAL	Texas Abortion Rights Action League
GTFO	Get the *freak* out
FWYW	Fart when you want
HV	Humanae Vitae
SP1	Pregnancy-specific beta 1-glycoprotein
AAS	Alive and smiling
2M2H	Too much to handle
BF	Best friend
SK8R	Skater
PRESH	Precious
FBF	Flashback Friday
XLNT	Excellent 
FU	*Freak* you
BT	Bite this
CWRR	'Catholic' Women for Reproductive Rights
UHGTBSM	You have got to be s#$t*ing me!
NWHN	National Women's Health Network
CYAL8R	See you later
YMCA	Young Men's Christian Association
SF	Someone farted
DWM	Divorced white male
UFMCC	Universal Fellowship of Metropolitan Community Churches
AB	American Birth Control League
BIB	Boss is back
OIB	Oh, I'm back
IISHR	International Institution for the Study of Human Reproduction
PSI	Population Services International
Q	Queue
GLSA	Gay Law Students Association
OTL	Out to lunch
OIC	Oh, I see
H8TTU	Hate to be you
CJR	Citizens for Judicial Restraint
BBT	Basal body temperature
SBIA	Standing back in amazement
NP	No problem
CCS	Clergy Consultation Service
TOS	Terms of service
SF	Someone farted
ADAD	Another day, another dollar
ND	Nice double
INC	incoming
BIO	I'm going to the bathroom (or) Bathroom break
GPO	[United States] Government Printing Office
XPOST	Cross-post. A link posted to a subreddit that was already shared on a different subreddit (Reddit)
GGA	Good game, all
NARW	National Assembly of Religious Women
HV	Have 
ILY	I love you
BFFLNMW	Best friends for life, no matter what
B-DAY	Birthday
ACLA	American Catholic Lawyers Association
AsDB	Asian Development Bank
NFS	Need for Speed
SAARC	South Asian Association for Regional Cooperation
SD	Sweet dreams
SOR	Shield of Roses
Ph.D.	Philosophiae doctor
OTFL	On the floor laughing
UF	You farted
HGP	Human Genome Project
ERS2	Eres tz / are you (Spanish SMS)
LMNK	Leave my name out
QQ (qq) (Q_Q)	crying eyes
Z	Said
NPG	Negative Population Growth
BD	Big deal
TUI	Turning you in
WAS	Wait a second
NAOP	National Association for Optional Parenthood
YARLY	Ya, really?
CO	Conscientious objector
EVO	Evolution
CUA	Catholic University of America
DD	Due diligence
@TEOTD	At the end of the day
HOPING	Helping in Normal Grieving
YRYOCC	You're running your own cuckoo clock
ZUP	What's up?
AIR	As I remember
PUSH	People United to Save Humanity
LGH	Lets get high
THT	Think happy thoughts
LDO	Like, duh obviously
NM	Nothing much
UF	You farted
ADMIN	Administrator
RYB	Read your Bible 
ACPT	Accept (e-mail, Government)
WAWA	Where are we at?
HNL	(w)Hole 'nother level
LAIA	Latin American Integration Association
ADMINR	Administrator (Government)
IFFS	International Federation of Fertility Societies
YCT	Your comment to?
AIDS	Acquired Immune Deficiency Syndrome
TLC	Tender loving care
BOP	bind on pickup
VFC	Voters for Choice
SBIA	Standing back in amazement
IPS	Institute for Policy Studies
SMAZED	Smoky haze (marijuana stoned)
CPG	Catholic Physicians Guild
IADB	Inter-American Development Bank
10M	Ten man
NCOG	National Council of Obstetrics and Gynecology
EZ	Easy
LLM	Master of Law
USAID	United States Agency for International Development
DNR	Do not resuscitate
RNC	Republican National Committee
RMMM	Read my mail man
IVF-DO	IVF-donor ova
RFRA	Religious Freedom Restoration Act
A/S/L	Age/sex/location
WASP	We Are Sexual Perverts
HEW	[United States Department of] Health, Education and Welfare
AVA	American Victims of Abortion
ABC	Already been chewed
HHS	[United States Department of] Health and Human Services
10Q	Thank you
JBS	John Birch Society
AAS	American Association of Suicidology
AAA	American Adoption Agency
TBA	To be aborted
SB	Senate Bill
IOOF	International Order of Odd Fellows
EPC	Environmental Policy Center
MEGO	My eyes glaze over
IANAC	I am not a crook
GUD	Good 
TAUMUALU	Thinking about you miss you always love you
HSG	Hysterosalpingogram
ZC	Zangger Committee
ACS	Americans for Common Sense
PRL	Prolactin
MRW	My reaction when... (Used with photo or gif)
URH	You are hot (U R Hot)
PWN	own
AGS	American Gynecological Society
MOO	My own opinion
GAC	Get a clue
DIIK	Darned if I know
AAYF	As always, your friend
FACP	Fellow of the American College of Physicians
STD	Sexually-transmitted disease
CRS 	Can't remember *stuff*
PAU	Pan American Union
POIDH	Picture, or it didn't happen
STFU	Shut the *freak* up
NSF	National Science Foundation
SRY	Sorry
EMILY	Early Money is Like Yeast
VSC	Voluntary surgical contraception
ZIFT	Zygote intra-fallopian transfer
ACDNT	Accident (e-mail, Government)
TEGWAR	The exciting game without any rules
CAM	Camera (SMS)
ANZUS	Australia-New Zealand-United States Security Treaty
JCAH	Joint Commission on the Accreditation of Hospitals
FOR	Fellowship of Reconciliation
YF	Wife
RH	Rhesus [positive or negative]
ACD	ALT / CONTROL / DELETE
AA	As above
MISS.(number)	child and her age. Miss.3 would be a 3-year old daughter
AMEND	Moms Experiencing Neonatal Death
AEU	American Ethical Union
AVS	Association for Voluntary Sterilization
BOM	Billings Ovulation Method
TSH	Tripping so hard
KUTGW	Keep up the good work
BTW	By the way 
AH	At home
AVES	Australian Voluntary Euthanasia Society
GBU	God bless you
IME	Institute of Medical Ethics
WRAP	White Ribbon Campaign Against Pornography
FDA	[United States] Food and Drug Administration
EPH	Edema/proteinuria/hypertension
ACL	American Collegians for Life
ALERT	American Life Education and Research Trust
NDA	Natural Death Act
SENPAI	someone older than you, someone you look up to
CB	Crazy *b*
SA	Sexaholics Anonymous
OT	Old Testament
RC	Roman Catholic
WVSC	Water vacuum suction curettage
PPP	Planned Parenthood Physicians
RFD	Rural free delivery
JJ (J/J)	Just joking
DOM	Deo optimo maximo
I2	I too (me too)
EMP	Electromagnetic pulse
WHAM	Women's Health Action Mobilization
DL	Down low
AF	April Fools
LMIRL	Lets meet in real life
BOSMKL	Bending over smacking my knee laughing
BD	Bachelor of Divinity
DAFUQ	(What) the *Freak*?
JFF	Just for fun
EZ	Easy
BEG	Big evil grin
MGB	May God bless
WEEBO	Describes a person obsessed with of Japanese culture
CULA	See you later alligator
GSA	General Services Administration
ADIP	Another day in paradise
SB	Should be
ACC	Arab Cooperation Council
YWSYLS	You win some, you lose some
PFT	Pretty *freaking* tight
IWHC	International Women's Health Coalition
FISH	First in, still here
AAME	American Academy of Medical Ethics
T:)T	Think happy thoughts
SNAFU	Situation normal all fouled up
kB	Kilobyte
NACC	North Atlantic Cooperation Council
PAU	Pan American Union
CBE	Center for Biomedical Ethics
IB	I'm back
FRCS	Fellow of the Royal College of Surgeons, London
NAZI	Nationalen Socialisten
DF	Don't fart
411	information'
CAPD	Continuous ambulatory peritoneal dialysis
NICU	Neonatal intensive care unit
NOPE	National Optimum Population Effort
FTBOMH	From the bottom of my heart
JMO	Just my opinion
NEA	Nuclear Energy Agency
BAO	Be aware of
INMARSAT	International Maritime Satellite Organization
TM	Trust me
CWRR	'Catholic' Women for Reproductive Rights
CACM	Central American Common Market
IHNI	I have no idea
CSC	Congregatio Sanctae Crucis
FBO	Facebook official (An official update from Facebook)
UR	You are / You're
WWYC	Write when you can
NWSC	National Women's Studies Conference
OTGH	Old-Time Gospel Hour
SMEXI	Combination of sexy and Mexican, used to describe attractive people
O	Over
R2N2	Reproductive Rights National Network
OSHA	Occupational Safety and Health Administration
DKP	Dragon kill points
TL	Too long
IPA	International Phonetic Alphabet
CCA	Christian Community Association
WOOMB	World Organization of the Ovulation Method Billings
ANM	Auxiliary nurse-midwife
ZDV	Zidovudine
W/E	Whatever
FIIK	*Freaked* if I know
FAQ	Frequently asked questions
OIC	Organization of the Islamic Conference
CFFC	Catholics' for a Free Choice
LSMT	Life-sustaining medical treatment
APA	American Psychoanalytic Association
DMNO	Dude Man No Offense
AMU	Arab Maghreb Union
NSFG	National Survey of Family Growth
TC	Transcervical
CR8	Create
G2GICYAL8ER	Got to go I'll see you later
ARHP	Association of Reproductive Health Professionals
NAJSN	National American Jewish Students Network
BFN	Bye for now
IDBI	I don't believe it
LMNK	Leave my name out
AIAA	Americans for International Aid and Adoption
CSII	Continuous subcutaneous insulin infusion
88	Bye-bye (Mandarin Chinese txt msgs) 
KDFU	Means Cracking (K) the (D as in Da) *freak* up
AAME	American Academy of Medical Ethics
NE	Any
IIRC	If I remember correctly
E123	Easy as one, two, three
FBF	Fat boy food (e.g. pizza, burgers, fries)
LTOD	Laptop of death
CRA CRA	Slang term meaning crazy
NAF	National Abortion Federation
BIP	Basic infertile pattern
FFA	Free for all
TOS	Terms of service
NEJM	New England Journal of Medicine
AMAP	As much as possible
YTB	You're the best
CAPD	Continuous ambulatory peritoneal dialysis
PC	Population Communication
NPC	National People's Congress
ETA	Edited to add
MOSS	Member of same sex
BG	Big grin
NDA	Natural Death Act
UF	You farted
NCCJ	National Conference of Christians and Jews
CARE	Co-operative for American Remittances to Everywhere
BCOS	Because
IWSN	I want sex now
FC'INGO	For crying out loud
LLB	Bachelor of Law
START	Strategic arms reduction treaty
UCS	Union of Concerned Scientists
FOAF	Friend of a friend
BGCS	Boyhood Gender Conformity Scale
LAPD	Los Angeles Police Department
TTUL	Talk to you later
UT2L	You take too long
MIRV	Multiple independently-targeted reentry vehicles
BIS	Best in slot
CT	Can't talk
DF	Don't fart
CURLO	See you around like a donut
SIM	Simian Immunodeficiency Virus
UNHCR	United Nations Office of the High Commissioner for Refugees
NCSW	National Conference on Social Welfare
NCHA	National Council on Higher Education
GIGO	Garbage in, garbage out
ICEA	International Childbirth Education Association
UOK	(Are) You ok?
IGP	I got to (go) pee
NPG	Negative Population Growth
RCS	Royal College of Surgeons
IG2R	I got to run
PZ	Peace 
R&D	Research and development
UWA	United Way of America
AORN	American Association of Registered Nurses
BIS	Bank for International Settlements
NASW	National Association of Social Workers
ACS	American College of Surgeons
F	Fart
YMMV	Your mileage may vary
SJR	Senate Joint Resolution
SD	Standard deviation
NFW	No *freaking* way
PKMN	Pokemon
CUA	See you around
KMT	Kiss my tushie
GTM	Giggling to myself
ACGME	Accreditation Council for Graduate Medical Education
DORBS	Adorable
PECAM	Platelet endothelial cell adhesion molecule
511	Too much information (more than 411)
FOMC	Falling off my chair
GGU2	Good game, you too
BYOC	Bring your own computer
NSTA	National Science Teachers Association
JJ (J/J)	Just joking
OMI	Oblates of Mary Immaculate
CULA	See you later alligator
NAWL	National Association of Women Lawyers
CWRR	'Catholic' Women for Reproductive Rights
JAM	Just a minute
CDA	Catholic Daughters of America
IGADD	Inter-Governmental Authority on Drought and Development
OYO	On your own
PIR	Parents in room
SPF	South Pacific Forum
DEGT	Dear (or Darling) daughter
ACOOG	American College of Osteopathic Obstetricians and Gynecologists
NBAU	No business as usual
RX	drugs or prescriptions
BSTS	Better safe than sorry
IVF-SET	IVF-surrogate embryo transfer
K	of C Knights of Columbus
FCC	Freedom of Choice Coalition
HYFR	Hell yeah, *Freaking* right!
LD	Long distance
AGPA	American Group Psychotherapy Association
0.02	My (or your) two cents worth
6Y	Sexy
AYS	Are you serious?
HOPE	Housing Opportunities for People Everywhere
POV	Point of view
2B	To be
86	Over
NEN	Norethindrone acetate
ELISA	Enzyme-linked immunosorbent assay
MEH	a shrug or shrugging shoulders
<3	broken heart
CSFC	Committee for the Survival of a Free Congress
EF4T	Effort
4AO	For adults only
CIAO	Good-bye (Italian word)
ImL	(in Arial font) Means I love you (a way of using the American sign language in text)
CBC	Congressional Black Caucus
OSA	Order of St. Augustine
7K	Sick
WWF	World Wildlife Fund
TY	Thank you
BOM	*b* of mine
EFM	Electronic fetal monitoring
LULT	Love you long time
ZOT	Zero tolerance
CUL	See you later
FPIA	Family Planning International Assistance Program
AISB	As I said before
CUL	See you later
AAAS	American Association for the Advancement of Science
2M2H	Too much too handle
j00r	Your
^^	read line or read message above
CLAB	Crying like a baby
RTSM	Read the stupid manual
MSG	Message
MLM	give the middle finger
BAMF	Bad *a* mother *f*
ICBM	Intercontinental ballistic missile
IYD	International Year of the Disabled
AYW	As you want / As you wish
CB	Crazy *b*
SM	Social media
EG	Evil grin
IMSB	I am so bored
GMV	Got my vote
G	Giggle
RTRMT	Retirement (email, Government)
IYC	International Year of the Child
ALS	Amyotrophic lateral sclerosis
EVO	Evolution
NAM	New age movement
SIS	sister
YHBW	You have been warned
F	Fart
DF	Don't fart
GTG	Got to go
AFAP	As far as possible
YKW	You know what
GSA	Girl Scouts of America
BIF	Before I forget
CE	[International Society of] Christian Endeavor
TBD	To be determined
CULA	See you later alligator
FOE	Friends of the Earth
CEI	Central European Initiative
BOHICA	Bend over here it comes again!
GnRH	Gonadotrophin-releasing hormone
MC	Member of Congress
FWIW	For what it's worth
PCUC	People Concerned for the Unborn Child
420	Lets get high
NALOPKT	Not a lot of people know that
4NR	Foreigner 
PDA	Population Development Association
SJD	Doctor of Juridical Science
IF	I farted
JCB	Bachelor of Canon Law
BEU	Benelux Economic Union
APL	Adopted People for Life
LLS	Laughing like *silly*
ARC	American Red Cross
1NAM	One in a million
PEEPS	People
?	I have a question
QQ (qq) (Q_Q)	crying eyes
BB	Bebi / Baby (Spanish SMS)
PBS	Public Broadcasting System
NIMH	National Institute of Mental Health
IUSS	If you say so
NVM	Never mind
OPEC	Organization of Petroleum Exporting Countries
WWI	Worldwatch Institute
IAAL	I am a lawyer
ICOMP	International Council on Management of Population Programmes
PLAN	Protect Life in All Nations
CFC	Combined Federal Campaign
IVD	Intravas device
HL	Half Life
CEAO	Communaute Economique de l'Afrique de l'Ouest
KEWL	Cool
EIB	European Investment Bank
AFAIK	As far as I know
UDDA	Uniform Determination of Death Act
Y	Yawn
BB	Be back
CCBA	Coalition of Concerned Black Americans
LERK	Leaving easy reach of keyboard
USAF	United States Air Force
FTL	For the loss
OMG	Oh my gosh
CU2	See you
ASHS	Association of Secular Humanist Societies
NAGAP	National Association of Gay Alcoholism Professionals
COPE	Committee on Political Education
TTFN	Ta ta for now
ProPAC	Progressive Political Action Committee
SOAB	Son of a *B*
MEHH	a sigh or sighing
OT	Occupational therapy
B	Be
YHBT	You have been trolled
C	Commonwealth
GTW	Multiglycosides of Tripterygium wilfordii
URH	You are hot (U R Hot)
PPFA	Planned Parenthood Federation of America
121	One-to-one (private chat initiation)
WWF	World Wildlife Fund
FAM	Fertility awareness method
CCD	Confraternity of Christian Doctrine
NOLSW	National Organization of Legal Social Workers
GFC	Gay Father's Coalition
Z	Said
PRB	Population Reference Bureau
CCEL	Christian Civic Education League
SMHID	Scratching my head in disbelief
AAMFT	American Association for Marriage and Family Therapy
VP	Vice President
NLSY	National Longitudinal Survey of Youth
ACE	American Council on Education
CM	Congregation for the Mission
MTFBWU	May the force be with you
LHO	Laughing head off
PPP	Planned Parenthood Physicians
ACA	Arms Control Association
SIECUS	Sex Information and Education Council of the United States
RU	Are you?
DTRT	Do the right thing
K8T	Katie
TURNT	Turn up
AOG	Assembly of God
CTC	Care to chat?
NH	Nice hand
PAW	People for the American Way
LOTI	Laughing on the inside
GTSY	Great (or good) to see you 
CBTV	Coalition for Better Television
JFGI	Just *freaking* Google it
EAK	Eating at keyboard
PPD	Purified protein derivative
CPG	Catholic Pharmaceutical Guild
IIRC	If I remember correctly
E2EG	Ear to ear grin
DAV	Disabled American Veterans
AGA	American Genetic Association
C/P	Cross post
H-BDAY	Happy Birthday
FWYW	Fart when you want
CBPP	Center for Budget and Policy Priorities
LDS	Latter-Day Saints
RFC	Religious Formation Conference
CARAL	California Abortion Rights Action League
AWOL	Absent without leave
CYE	Check your e-mail
AF	As *Freak*
BYOB	Bring your own beer 
Bloke	Man (Discord)
PDW	People's Daily World Magazine
GEEP	Gonadotropin-releasing hormone agonist and exogenous estradiol and
SART	Society for Assisted Reproductive Technologies
KIA	Know it all
HRU	How are you?
GJ	Good job
CYAL8R	See you later
ALI	American Liberties Institute
UNDP	United Nations Development Program
OSU	Order of St. Ursula
NERF	Changed and is now weaker
UDM	U (You) da (the) man
RG	Rio Group
URTM	You are the man
MDA	Muscular dystrophy association
ACC	Anyone can come
;S	Gentle warning, like Hmm? What did you say?
AFAIUI	As far as I understand it
IFN	Interferon
T4BU	Thanks for being you
SOWM	Someone with me
PWA	Person
PU	That stinks!
GIGO	Garbage in, garbage out
NAOP	National Association for Optional Parenthood
PS	Pro-Lifers for Survival
YWSYLS	You win some, you lose some
FFM	Fund for a Feminist Majority
CRASH	Center for Reproductive and Sexual Health
NET	Norethindrone
CNF	Conservation Network Foundation
IUI	Intra-uterine insemination
ROTC	Reserve Officers Training Corps
USCL	United States Coalition for Life
NOYB	None of your business
VRY	Very
LABIA	Lesbians and Bisexuals in Action
R	are
NFS	Need for Speed
MCC	Metropolitan Community Church
GM-CSF	Granulocyte-macrophage colony-stimulating factor
AFP	[Maternal] alpha-feto protein
WAN2TLK	Want to talk
LTS	Laughing to self
RTNTN	Retention (email, Government)
GS	Good shot
HIV	Human immunodeficiency virus
ILGWU	International Ladies' Garment Workers' Union
DWF	Divorced white female
DL	Download
DM	Do me
CX	Correction
CRLP	Center for Reproductive Law and Policy
EZY	Easy
ISIS	Institute for the Scientific Investigation of Sexuality
Ph.D.	Philosophiae doctor
XLNT	Excellent 
PDA	Population Development Association
GB	Gigabyte
MCH	[Department of] Maternal and Child Health
DC	Disconnect
AE	Artificial embryonation
GLE1	Good luck everyone
FWYW	Fart when you want
O	hugs
VHEMT	Voluntary Human Extinction Movement
OBV	Obviously
UNFAO	United Nations Food and Agricultural Organization
E1	Everyone
AMEND	Moms Experiencing Neonatal Death
Feelsgoodman	A social meme that means to feel positive.
B2W	Back to work
NEC	National Ecumenical Coalition
?	I don't understand what you mean
FC	Fingers crossed
DS	Dear (or Darling) son
OFC	Of course
CRIT 	critical hit
OSM	Order of the Servants of Mary
CISPES	Committee in Solidarity With the People of El Salvador
TOU	Thinking of you
GGOH	Gotta Get Outa Here
7K	Sick
AAR	At any rate
QALY	Quality adjusted life years
NATO	North Atlantic Treaty Organization
HLS	Human Life Statute
SPI	Sisters of Perpetual Indulgence
IDB	Islamic Development Bank
WEU	Western European Union
MTFBWU	May the force be with you
AAR	American Academy of Religion
GAFC	Get a *freaking* clue
STOP	Save the Oppressed People
CBSS	Council of the Baltic Sea States
IUP	Intrauterine pregnancy
SWAG	free stuff and giveaways from tech tradeshows (definition)
RBAY	Right back at you
BIO	I'm going to the bathroom (or) Bathroom break
HTLV	Human T-Cell Lymphotropic Virus
NAM	Nonaligned Movement
ADR	Address
DDG	Drop dead gorgeous
GALAS	Great American Lesbian Art Show
CTC	Care to chat?
IR	International Review
NRFF	National Research Foundation for Fertility
OMG	Oh my God
IVF	In-vitro fertilization
BYOD	Bring your own device
STP	Standard temperature and pressure
SADC	Southern African Development Community
AYOR	At your own risk
Xn	Christian
PTO	Personal time off
WISP	Winning is so pleasurable
NLF	National Liberation Front
CO	Conscientious objector
OURS	Organization for United Response
TOY	Thinking of you
TEF	The Environmental Fund
CMGR	Community manager
SF	Someone farted
YWHNB	Yes, we have no bananas
XLNT	Excellent 
YTB	Youth talk back
CURLO	See you around like a donut
NOOB	someone who is bad at (online) games
2EZ	Too easy
IFA	International Fertility Association
WEBO	Webopedia
IDK	I don't know
KPC	Keeping parents clueless
NP	No problem
OSHA	Occupational Safety and Health Administration
IPPF	International Planned Parenthood Federation
JW	Jehovah's Witness
WCL	World Confederation of Labor
NE	Any
NIRS	Nuclear Information Resource Service
FOAF	Friend of a friend
AAS	American Association of Suicidology
PLEA	Pro-Life Educational Association
IK	I know
OGC	Office of General Council
GJ	Good job
SETE	Smiling Ear-to-Ear
LVM	Left voice mail
?4U	I have a question for you
SA	Salvation Army
NFL	National Football League
;S	Gentle warning, like Hmm? What did you say?
WTT	Want to trade?
DAE	Does anyone else?
TILIS	Tell it like it is
O	Opponent
LLD	Doctor of Law
NHANES	National Health and Nutrition Examination Survey
LD50	Lethal Dose 50%
AFAP	As far as possible
CSL	Can't stop laughing
GFN	Gone for now
KS	Kill then steal
AWMA	American Women's Medical Association
BB	Big brother
U-L	You will
LOLH	Laughing out loud hysterically
DIKU	Do I know you?
CDC	Centers for Disease Control
CMA	Canadian Medical Association
YBS	You'll be sorry
IDUNNO	I don't know
TNSTAAFL	There's no such thing as a free lunch
VGG	Very good game
WRU@	Where are you at?
WIC	Women, Infants and Children Program
ECOSOC	[United Nations] Economic and Social Council
IAAD	I am a doctor
CRW	Council of Religious Women
CFA	Committee for Future America
NTHING	Nothing (SMS)
Cakeday	Birthday (Reddit)
WUF	Where are you from?
FTL	For the loss
MEHH	a sigh or sighing
BSA	Boy Scouts of America
FBOW	For better or worse
UF	You farted
FWB	Friend with benefits
MIRL	Me in real life
DGA	Don't go anywhere
EI	Eat it
WIIFM	What's in it for me?
NINA	No Irish need apply
GOMB	Get off my back
CP	Chat post (or continue in IM)
GRATZ	Congratulations
LLB	Bachelor of Law
OCC	Order of Calced Carmelites
WNDC	Women's National Democratic Club
ALL	American Life League
SWALK	Sealed (or sealed) with a loving kiss
AFDC	American Family Defense Coalition
DERP	stupid or silly
CLAB	Crying like a baby
HMO	Health maintenance organization
TIR	Teacher in room
LLGB	Love, later, God bless
APP	Application
UF	You farted
PEEPS	People
TTYS	Talk to you soon
LOLH	Laughing out loud hysterically
DV8	Deviate
STW	Search the Web
LH	Luteinizing hormone
TYFC	Thank you for charity
LTNS	Long time no see
^URS	Up yours
YAF	Young Americans for Freedom
PSR	Physicians for Social Responsibility
IGA	International Gay Association
MoD	March of Dimes
APAC	All praise and credit
TIET	Transvaginal intratubal embryo transfer
BRB	Be right back
CCC	Customs Cooperation Council
ARM	Abortion Rights Mobilization
FAAK	Falling asleep at keyboard
SH	Same here
CRA	Center for Reproductive Alternatives
JCB	Bachelor of Canon Law
TARAL	Texas Abortion Rights Action League
OP	Optimum Population, Inc.
CFC	Chlorofluourocarbons
PG	Prostaglandin
GG	Gotta Go
PAHO	Pan American Health Organization
CTSA	Catholic Theological Society of America
VSC	Very soft chuckle
UER	User effectiveness rate
UR2YS4ME	You are too wise for me
CNS	Central nervous system
IBM	International Business Machine
XD	a devilish smile
DKP	Dragon kill points
PHA	Public Housing Administration
YHBW	You have been warned
LDL	Low-density lipoprotein
CB	Chat break
FAA	Federal Aviation Administration
KIA	Killed in action
DV8	Deviate
WISC	Washington Interreligious Staff Council
IASR	International Academy of Sex Research
NMR	Nuclear magnetic resonance [spectroscopy]
KI	Karyopyknotic index
et	seqEt sequens
DAFUQ	(What) the *Freak*?
GS	Good shot
IBEC	International Bank for Economic Cooperation
NC	Nice crib
WTT	Want to trade?
AFC	Apostolate for Family Consecration
GDR	Grinning, ducking, and running
TLB	The Living Bank
OCI	Ovum capture inhibitor
DL	Down low
CHA	Catholic Health Association
UAE	United Arab Emirates
BOL	Best of luck
FHA	Federal Housing Administration
FWM	Fine with me
GG	Good Game
AEA	Adoption Exchange Program
URTM	You are the man
MR.(number)	child and his age. Mr.3 would be a 3-year old son
IGHT	I got high tonight
88	Hugs and kisses
VC	Voice chat
EAF	Environmental Action Foundation
WFP	World Food Program
SOL	Sooner or later
ImL	(in Arial font) Means I love you (a way of using the American sign language in text)
ATSITS	All the stars in the sky
FWYW	Fart when you want
TTTT	These things take time
AMOF	As a matter of fact
WU	What's up?
ICEDI	I can't even discuss it
BT	Between technologies
AAD	Alliance Against Defamation
VA	Veterans Administration
GR&D	Grinning, running and ducking
BBIAF	Be back in a few
GAS	Got a second?
CPF	Committee to Protect the Family
FWP	First world problems
ASAHP	Association of Schools of Allied Health Professions
ACK	Acknowledge
SWAK	Sent (or sealed) with a kiss
LAS	League of Arab States
BRT	Be right there
MRT	Modified ReTweet  (Twitter slang)
CTS	Catholic Truth Society
P2P	Peer to peer
VIP	Voter identification project
TFTF	Thanks for the follow (Twitter slang)
WRA	Women of reproductive age
SU	Shut up
10Q	Thank you
OCI	Ovum capture inhibitor
MMK	okay? (as a question)
NCCW	National Council of Catholic Women
ICC	Interstate Commerce Commission
MBS	Mutual Broadcasting System
EC	European Community
182	I hate you
DGA	Don't go anywhere
RT	Roger that
KMK	Kiss my keister
OEO	Office of Economic Opportunity
NFP	Natural family planning
UW	You're welcome
ALI	American Law Institute
OFC	Of course
SLAA	Sex and Love Addicts Anonymous
2NTE	Tonight
<3	broken heart
RLY	Really
ASF	American Suicide Foundation
ZOT	Zero tolerance
APHA	American Public Health Association
CPM	Cesarian Prevention Movement
RVN	Republic of Viet Nam
LD	Later, dude
ALI	American Law Institute
FFS	For *freak'*sakes
NMH	Not much here
SKAT	Sex Knowledge and Attitude Test
ILO	International Labor Organization
NBWHP	National Black Women's Health Project
WEBO	Webopedia
ASAP	As soon as possible
ACE	Alliance for Chastity Education
AU	Angstrom unit
ASLM	American Society of Law and Medicine
ASPEN	American Society for Parenteral and Enteral Nutrition
IH2F	I have to fart
NIMBY	Not in my back yard
LTOD	Laptop of death
BOE	bind on equip
Buff	changed and is now stronger
EMFBI	Excuse me for butting in
TMYL	Tell me your location
KOS	Kid over shoulder
MEZ	mesmerize
BBIAM	Be back in a minute
PUG	Pick up group
NWLC	National Women's Law Center
HHH	Hyperornithinaemia, Hyperammonaemia, and Homocitrullinuria Syndrome
ANA	American Nurses Association
PVP	Player versus player
MNC	Mother nature calls
NAPSAC	National Association of Parents and Professionals for Safe Alternatives in 
DEGT	Dear (or Darling) daughter
APWU	American Postal Workers Union
SH	Same here
CIA	Central Intelligence Agency
FTA-Abs	Fluorescent treponemal antibody-absorption
PRO	Population Renewal Office
SO	Significant other
ANA	American Nurses Association
SCI-COP	Committee for the Scientific Investigation of Claims of the Paranormal
MRT	Modified ReTweet  (Twitter slang)
BOE	bind on equip
CSOW	Commission on the Status of Women
PP/WP	Planned Parenthood/World Population
ZZZZ	Sleeping (or bored)
UF	You farted
BFAW	Best friend at work
AFSCME	American Federation of State, County, and Municipal Employees
SCAW	Scientists Center for Animal Welfare
URTM	You are the man
NSW	New South Wales
CS	Christian Science
MGMT	Management
CAMPUS	Coalition of American Pro-Life University Students
ADL	Anti-Defamation League [of B'nai B'rith]
VBAC	Vaginal birth after Cesarian [section]
RSV	Revised standard version
ARL	Americans for Religious Liberty
4NR	Foreigner 
RX	Regards
NIH	National Institute of Health
MWAH	kiss (it is is the sound made when kissing through the air)
AFFA	Angels Forever, Forever Angels
AFP	[Maternal] alpha-feto protein
AAMOI	As a matter of interest
HTH	Hope this helps
SUP	What's up?
UAE	United Arab Emirates
PD	Peak day
?	I don't understand what you mean
PCI	Pax Christi International
BBQ	Barbeque, Ownage, shooting score/frag
APO	Army Post Office
TCOY	Take care of yourself
e.g.	Exempli gratia
AISA	Adoption Information Service Agency
WAM	Wait a minute
PZ	Peace 
NICA	National Interfaith Coalition on Aging
MFI	Mad for it
SOUL	Save Our Unwanted Life
4AO	For adults only
CORE	Congress of Racial Equality
@TEOTD	At the end of the day
NMJC	Nothing much, just chilling
FARM	Farm Animal Reform Movement
*w*	wink 
AMF	Arab Monetary Fund
EKG	Electrocardiogram
CUSA	Cavitron ultrasonic surgical aspirator
IHM	[Servants of the] Immaculate Heart of Mary
NOWL	knowledge
LFG	Looking for group
CULT	Catholics United Against Liberation Theology
PDA	Pregnancy Disability Act
LHSX	Lets have sex
UFL	University Faculty for Life
GMA	Gay Militant Atheists
ACA	Americans for a Constitutional Amendment
WUCIWUG	What you see is what you get
WU	What's up?
SMH	Shaking my head
SJW	Social justice warrior
DSP	Daughters of St. Paul
HP	Hit points / Health points
EGF	Epidermal growth factor
OL	Old lady
NET-EN	Norethisterone enanthate
LNT	lost in translation
AFJ	Alliance for Justice
ASIG	And so it goes
PRO	Population Renewal Office
DW	Dear (or Darling) wife
XME	Excuse Me
VITI	Vaginal intratubal insemination
K	Okay
BAE	Before anyone else
CSE	Classroom sex education system
DEEZ NUTZ	A phrase used in online chat to annoy or frustrate those involved in the conversation.
PUSH	People United to Save Humanity
BFN	Bye for now
MICU	Medical intensive care unit
GAMDA	Group Against Media Dishonesty on Abortion
DAD	Dads Against Discrimination
LTD	Living the dream
IYC	International Year of the Child
19	Zero hand
FEC	Federal Elections Commission
SF	Someone farted
ELI5	Explain like I'm 5
PYT	Pretty young thing
DF	Don't fart
UT	Unreal Tournament
BHL8	Be home late
IRCAR	International Reference Center for Abortion Research
ROFLCOPTER	Rolling on floor laughing and spinning around
IAO	I am out (of here)
AFP	[Maternal] alpha-feto protein
GTA	Gay Teachers Association
FCC	Federal Communications Commission
QTPI	Cutie pie
AOH	Ancient Order of Hibernians
CYEP	Close your eyes partner
QC	Quality control
TWSS	That's what she said
AFAIK	As far as I know
CID	Consider it done
EPK&C	Early prenatal karyotype farenand cell scan
FML	*Freak* My Life
RFD	Rural free delivery
NWRA	National Welfare Rights Association
GLE	Good luck everyone
NSM	National Survey of Men
FUBAR	Fouled up beyond all recognition
PMFJI	Pardon me for jumping in
MOSS	Member of same sex
WRU@	Where are you at?
PG	Prostaglandin
FOLKS	Friends of Little Kids
DC	Doctor of Chiropractic
AFZ	Acronym Free Zone
HAK	Hug and kiss
ECWA	Economic Commission for Western Asia
DGTG	Don't go there, girlfriend
LLM	Master of Law
AU	Angstrom unit
LMFAO	Laughing my freaking *a* off
UFWM	You *freaking* with me?
PCI	Population Communications International
ICRC	International Committee of the Red Cross
CPG	Catholic Pharmaceutical Guild
COMECON	Coordinating Committee on Export Controls
SAA	Sexual Addicts Anonymous
FAF	Funny as *freak*
FA	Fundamentalists Anonymous
DN	Down
459	Means I love you (ILY is 459 using keypad numbers)
RU	Roussel-Uclaf
DINK	Double-income, no kids
NAS	National Association of Scholars
RIP	Rest in peace
EQ	EverQuest
LAPAC	Life Amendment Political Action Committee
IAETF	International Anti-Euthanasia Task Force
H-MDAY	Happy Mother's Day
OOTD	One of these days
GP	General practitioner
TTYL	Talk to you later
AZN	Asian
AYW	As you were
IHM	[Servants of the] Immaculate Heart of Mary
TLB	The Living Bank
SC	Sisters of Charity
FSH	Follicle-stimulating hormone
MBA	Master of Business Administration
UKTR	You know that's right
IUCD	Intra-uterine contraceptive device
FFM	Fund for a Feminist Majority
MOS	Mother over shoulder
VSF	Very sad face
CPC	Crisis Pregnancy Center
NFS	National Fertility Study
MB	Mamma's boy
TANKING	owning
RN	Registered nurse
APA	American Pharmaceutical Association
IFAD	International Fund for Agricultural Development
F2P	Free to play
UL	Upload
FAY	*Freak* all you
420	Lets get high
PROBS	Probably
XLR8	faster or going faster
HALP	Help (Discord)
AWOL	Absent without leave
NYPLC	National Youth Pro-Life Coalition
CUMID	See you in my dreams
TMB	Tweet me back (Twitter slang)
GNP	Gross national product
FIL	Father in law
DD	Dear (or Darling) daughter
MAMA	Mothers Against Minor's Abortions
BATF	Bureau of Alcohol, Tobacco and Firearms
STFU	Shut the *freak* up
CUMID	See you in my dreams
RCP	Royal College of Physicians
PAW	People for the American Way
MA	Master of Arts
NOOB	someone who is bad at (online) games
QFI	Quoted for irony
QFT	Quoted for truth
TARFU	Things Are Really *fouled* Up.
BOYF	Boyfriend
HIV-Ag	Human immunodeficiency virus antigen
BBN	Bye, bye now
X!	a typical woman
IMP	Imprimatur
OTW	Off to work
XPOST	Cross-post. A link posted to a subreddit that was already shared on a different subreddit (Reddit)
WADB	West African Development Bank
TU	Thank you
JTLYK	Just to let you know
BSEC	Black Sea Economic Cooperation Zone
1CE	Once
PEI	Prince Edward Island
55555	Laughing (In Thai language the number 5 is pronounced 'ha'.)
POSSLQ	Person of the opposite sex sharing living quarters
WKD	Weekend
VVF	Vesico-vaginal fistula
SHID	Slapping head in disgust
CBS	Columbia Broadcasting System
BN	Bad news
BADEA	Banque Arabe de Developpement Economique en Afrique
R2N2	Reproductive Rights National Network
LD	Later, dude
PPIH	Population Planning and International Health
U-L	You will
JDL	Jewish Defense League
BCIE	Banco Centroamericano de Integracion Economico
DYOR	Do your own research (common stock market chat slang)
404	I don't know
DEIS	Draft environmental impact statement
B4N	Bye for now
NCCC	National Coalition of Clergy and Laity
LFM	Looking for more
WNDC	Women's National Democratic Club
W/B	Write back
B	Back
CUA	See you around
86	Over
AVC	American Veterans Committee
CACM	Central American Common Market
EWG	Evil wicked grin (in fun, teasing)
BWL	Bursting with laughter 
UNCRTN	Uncertain
WAP	Women Against Pornography
DF	Don't even go there
IVD	Intravas device
PAW	Parents are watching
IHS	Indian Health Service
DUR	Do you remember?
TFS	Thanks for sharing
TOJ	Tears of joy
H	Hug
RCP	Revolutionary Communist Party [of the U.S.]
RTWFQ	Read the whole *freaking* question
FUBAR	Fouled up beyond all recognition
YCLIU	You can look it up
E123	Easy as one, two, three
ALSE	Advocates for Gay and Lesbian State Employees
GTC	Global Tomorrow Coalition, Inc.
6Y	Sexy
FW	Forward
PHS	[United States] Public Health Service
HATTS	Hemagglutination treponemal test for syphilis
ADD	Address
BCS	Bethany Christian Services
APHA	American Protestant Hospital Association
KMA	Kiss my *a*
NR	Nice roll
FWYW	Fart when you want
HC	Holy Communion
TNSTAAFL	There's no such thing as a free lunch
PROGGY	computer program
PP5	Placental protein 5
ACCL	American Citizens Concerned for Life
AAA	Americans Against Abortion
ICASC	International Contraception, Abortion, and Sterilization Campaign
SF	Someone farted
LWOS	Laughing without smiling
PIP	Peeing in pants (laughing hard)
TA	Thanks a lot
RUOK	Are you okay?
JAMA	Journal of the American Medical Association
OPM	Office of Personnel Management
SQ	Square
AfDB	African Development Bank
VOC	Victims of Choice
FC	Full card
ALG	American Lawyer's Guild
BBIAS	Be back in a sec
ILO0	International Labor Organization
XYZ	Examine your zipper
SIGMA	Sisters in Gay Ministry Associated
GLAD	Gay and Lesbian Awareness Da
ACF	Americans for Constitutional Freedom
LRF	Luteinizing releasing factor
HOW	Happiness of Womanhood
PK	Psychokinesis
FYI	For your information
YOLO	You only live once
UR	You are / You're
SDAT	Senile Dementia, Alzheimer's Type
FWYW	Fart when you want
NAPN	National Association of Pro-Life Nurses
TAU	Thinking about u (you)
MYOB	Mind your own business
RRN	Reproductive Rights Network
AID	[United States] Agency for International Development
OP	Order of Preachers
GNITE	Good night
WB	Welcome back
EIP	Editing in progress
AAK	Alive and kicking
ICM	Intergovernmental Committee for Migration
CYA	See you
Bloke	Man (Discord)
ITOP	Induced termination of pregnancy
ACE	Alliance for Chastity Education
COB	Close of business
NIB	Nordic Investment Bank
K	of C Knights of Columbus
UF	You farted
NPC	Non-playing character
2M2H	Too much to handle
HB	Hurry back
CMB	Call me back
IME	Institute of Medical Ethics
BOLO	Be on the look out
W/END	Weekend
TPTB	The powers that be
SSDD	Same stuff, different day
CU	See you too
^5	High-five
AE	Artificial embryonation
OI	Osteogenesis imperfecta
SRY	Sorry
FWIW	For what it's worth
IMHO	In my humble opinion
MIC	Maternal and Infant Care
IMS	I am sorry
SQUASH	Super Queers United Against Savage Heterosexuals
LC-WS	Lutheran Church-Wisconsin Synod
ADIP	Another day in paradise
EWI	Emailing while intoxicated
AMF	Arab Monetary Fund
HRH	His or Her Royal Highness
TC	Take care
CRASH	Committee Against Racism, Sexism, and Heterosexism
OG	Original gangster
EEG	Electroencephalogram
NIFOC	Naked in front of computer
AAD	Alliance Against Defamation
MPA	Master of Public Administration
TMWFI	Take my word for it
PST	Please send tell
SPTO	Spoke to
OTP	On the phone
IH2F	I have to fart
CRE8	Create
KMA	Kiss my *a*
NET-EN	Norethisterone enanthate
IR	International Review
2MI	Too much information
UF	You farted
NRDC	National Resource Defense Council
OTC	Over the counter
FIF	*Freak* I'm funny
IFRP	International Fertility Research Program
BG	Big grin
JK (J/K)	Just kidding
PDS	Please don't shoot
NCHLA	National Committee for a Human Life Amendment
*s*	smile  
FART	Floor Assistance Rescue Team
j00r	Your
PSHA	Public Service Health Act
IAWS	Intercollegiate Association of Women Students
OR	Operation Rescue
NIMBY	Not in my back yard
BISFLATM	Boy, I sure feel like a turquoise monkey! (unverified)
FAO	Food and Agricultural Organization
STOPP	Stop Planned Parenthood
F2P	Free to play
FUD	Face up deal
1337	Leet, meaning 'elite'
AYSOS	Are you stupid or something?
TYFYC	Thank you for your comment
GEA	Gay Educators Association
VHEMT	Voluntary Human Extinction Movement
PA	Parents Anonymous
NRHRC	National Rehabilitation Hospital Research Center
ATP	Adenosine triphosphate
YCT	Your comment to?
IIB	International Investment Bank
RW	Real world
MINURSO	United Nations Mission for the Referendum in Western Sahara
B&	Banned
SIG	Special Interest Group
USCC	United States Catholic Conference
HMG	Human menopausal gonadotrophin
IAC	In any case
MEP	Multiple exposure photography
WCA	Who cares anyway
YAF	Young Americans for Freedom
<33	heart or love (more 3s is a bigger heart)
omfglmaobbqrofl	oh my *freaking* god, laugh my *a* off, owned, roll on floor spinning around I'm so sad
KB	Kick butt
PROGGY	computer program
QTPI	Cutie pie
DC	Developed country
MM	Sister (Mandarin Chinese txt msg)
OT	Old Testament
L2G	(would) Love to go
IH2F	I have to fart
AQAP	As quick (or quiet) as possible
ABM	Anti-ballistic missile
IIED	International Institute for Environment and Development
SPTO	Spoke to
VIP	Voluntary interruption of pregnancy
FEW	Federally Employed Women
LHM	Lord help me
GANK	a player ambush or unfair player kill
ITT	In This Thread
NFP	Natural family planning
CICO	Coffee in, coffee out
FOMCL	Falling off my chair laughing
NCWUS	National Council of Women of the United States
SS	So sorry
SIGMA	Sisters in Gay Ministry Associated
BELF	Blood Elf
CRF	Constitutional Rights Foundation
NCLR	National Center for Lesbian Rights
VBS	Very big smile
PLU	People like us
CU	See you
ACPT	Accept (e-mail, Government)
ITU	International Telecommunication Union
WIU	Wrap it up
GGP	Got to go pee
OAU	Organization of African Unity
FWM	Fine with me
P2P	Parent to parent
G2CU	Good to see you
CIAO	Good-bye (Italian word)
ESCWA	Economic and Social Commission for Western Asia
HOPING	Helping in Normal Grieving
GL	Good luck
ARE	Acronym rich environment
VOA	Voice of America
CARD	Committee Against Registration and the Draft
HAWT	Have a wonderful day (out-dated, see next in list)
411	information'
CBS	Columbia Broadcasting System
ANM	Auxiliary nurse-midwife
JHPIEGO	Johns Hopkins Program for International Education in Gynecology and 
L/GHTS	Lesbian and Gay Humanists
DM	Deutsche Mark
X	Kiss
KIT	Keep in touch
FISH	Fluorescent in-situ hybridization
SOMY	Sick of me yet?
IBRC	Infant Bioethical Review Committee
ARM	Abortion Rights Mobilization
CWLA	Child Welfare League of America
JPSA	Joint Program for the Study of Abortion
NSFL	Not safe for life
LBS	Laughing, but serious
<3	broken heart
AIAMU	And I am a money's uncle
LC-MS	Lutheran Church-Missouri Synod
DHS	Demographic and Health Surveys
MYO	Mind your own (business)
LARFPC	Los Angeles Regional Family Planning Council
SJD	Doctor of Juridical Science
SWAG	Scientific wild *a* guess
YR	Yeah right
MSW	Master of Social Work
PROGGY	computer program
FACE	Freedom of Access to Clinic Entrances [Act]
AIPOP	American Institute of Public Opinion Poll
MFI	Mad for it
NAMBLA	North American Man-Boy Love Association
M8	Mate
420	Lets get high
SOWM	Someone with me
TQ	Te quiero / I love you (Spanish SMS)
GB	Gigabyte
O4U	Only for you
AFESD	Arab Fund for Economic and Social Development
CWA	Concerned Women for America
YGG	You go girl
ITU	International Telecommunication Union
OP	Order of Preachers
H	Hug
K	of P Knights of Pythias
DORIS	Defending Our Rights in the Streets
RW	Renaissance Women
H.J.R.	House Joint Resolution
CNS	Central nervous system
JMO	Just my opinion
PEN	[International Association of] Poets, Playwrights, Editors, Essayists, and 
NE	Any
VEG	Very evil grin
2M2H	Too much to handle
BSOD	Blue screen of death
OMW	On my way
WUZ	was
TTAPS	Toon, Turco, Ackerman, Pollack, and Sagan
CD	Congressional district
FY	Fiscal year
PM	Private Message
MCH	[Department of] Maternal and Child Health
NCC	National Council of Churches
NC	Nordic Council
EOL	End of life
PRT	Party
POS	Parent over shoulder
PCA	Permanent Court of Arbitration
ICFILWU	I could fall in love with you
Z	Zero
ONUSAL	United Nations Observer Mission in El Salvador
F	Fart
IUI	Intra-uterine insemination
ESMP	Enhanced survival of multifetal pregnancy
4EAE	Forever and ever 
NS	Nice score
NGF	National Genetics Foundation
GSA	General Services Administration
NBC	National Broadcasting Company
ACP	American College of Physicians
WTB	Want to buy
CCL	Couple to Couple League
T+	Think positive
CX	Correction
ADN	Any day now
EST	[Werner] Erhardt Sensitivity Training Seminars
AFK	Away from keyboard
et	seqEt sequens
IRTLF	International Right to Life Federation
SD	Senile dementia
BIS	Best in slot
143	I love you
IV	Intravenous
DAE	Does anyone else?
OTP	On the phone
PISS	Put in some sugar
2MI	Too much information
NMU	Not much, you?
ORLY	Oh really?
WAP	Whale Adoption Project
NIMBY	Not in my back yard
ICJ	International Court of Justice
WUP	What's up?
ASMA	American Student Medical Association
WRK	Work
BRBB	Be right back *babe*
JCB	Bachelor of Canon Law
GTC	Global Tomorrow Coalition, Inc.
DM	Doesn't matter
FLS	Front Line States
AHA	American Historical Association
ND	Nice double
CPUSA	Communist Party of the United States of America
831	I love you (8 letters, 3 words, 1 meaning)
TFS	Thanks for sharing
CHAP	Child Health Assurance Program
HUB	Head up butt
CUF	Catholics United for the Faith
BAK	Back at keyboard
Abp	Archbishop
NGLTF	National Gay and Lesbian Task Force
XYL	Ex-young lady, meaning wife. (amateur radio) 
F	Fart
COH	City of Heroes
S&M	Sado-masochism
88	Hugs and kisses
GAFC	Get a *freaking* clue
XLR8	faster or going faster
ELI	Environmental Law Institute
NCNW	National Council of Negro Women
GSA	Gay Students Association
RVN	Republic of Viet Nam
AID	Artificial insemination
SICNR	Sorry, I could not resist
S'OK	It' (s) okay (ok)
RIP	Requiescat in pace
AIM	Accuracy in Media
CHAP	Child Health Assurance Program
GD/R	Grinning, ducking, and running
PP5	Placental protein 5
BTDT	Been there, done that
AFP	[Maternal] alpha-feto protein
HV	Have 
SUITM	See you in the morning
ECWA	Economic Commission for Western Asia
55555	Crying your eyes out (Mandarin Chinese txt msgs)
UNAVEM	United Nations Angola Verification Mission
LVM	Left voice mail
1432	I love you too
NCFPI	National Clearinghouse for Family Planning Information
NSA	No strings attached
KB	Keyboard
OPEN	Organization to Promote Equality Now
ZUP	What's up?
ROC	Republic of China
DERP	stupid or silly
LTLWDLS	Let's twist like we did last summer
B/C	Because
CID	Criminal Investigation Department
PST	Pacific Standard Time
MNSG	Mensaje (message in Spanish)
NFPRHA	National Family Planning and Reproductive Health Association
NSM	National Survey of Men
FART	Floor Assistance Rescue Team
KS	Kaposi's Sarcoma
QSL	Reply 
AASHTA	As always, Sheldon has the answer (Bike mechanic Sheldon Brown)
FUTAB	Feet up, take a break
SPST	Same place, same time
YW	You're welcome
CLS	Critical Legal Studies
GCC	Gay Community Center
EOM	End of message
LMMFAO	Laughing my mother freaking a** off
j00	You
BIOYN	Blow it out your nose
OO	Over and out
NARRAL	National Abortion and Reproductive Rights Action League
OC	Order of Cistercians
ICS	Institute for Creation Spirituality
CIOMS	Council for International Organizations of Medical Sciences
UOK	(Are) You ok?
IWY	International Women's Year
Facepalm	Used to represent the gesture of smacking your forehead with your palm to express embarrassment or frustration
MACS	Multicenter AIDS Cohort Study
OVA	Over
LOLO	Lots of love
XOXOXO	Hugs & Kisses
URA*	You are a star
NMJC	Nothing much, just chilling
RTI	Research Triangle Institute
GTW	Multiglycosides of Tripterygium wilfordii
QOL	Quality of life
GMV	Got my vote
XOXOXO	Hugs & Kisses
NPC	Non-playing character
YG	Young gentleman
OTT	Over the top
2G2BT	Too good to be true
OB	Oh brother
SAARC	South Asian Association for Regional Cooperation
WOW	World of Warcraft
j00	You
GIC	Gift in crib
LMS	Like my status (Facebook)
SUX	Meanings sucks or it sucks
BOM	*b* of mine
L2G	(would) Love to go
P2P	Parent to parent
IVH	Intraventricular hemorrhage
VOA	Voice of America
ICBW	It could be worse
PEP	Promoting Enduring Peace
MCHR	Medical Committee for Human Rights
RTSM	Read the stupid manual
NBD	No big deal
WLDF	Women's Legal Defense Fund
DHEW	Department of Health, Education, and Welfare
OECS	Organization of Eastern Caribbean States
EMBAR	Embarassing
JAC	Just a second
ABC	American Baby Code
JLIC	Jewish Life Issues Committee
NCCL	National Committee of Catholic Laymen
FUAA	Fathers United Against Abortion
GSA	Genetics Society of America
TSNF	That's so not fair
LQTM	Laughing quietly to myself
SRA	State's Rights Amendment
AHA	American Humane Association
GMTA	Great minds think alike
SC	Stay cool
IYQ	I like you
Clear-TV	Christian Leaders for Responsible Television
EPS	Early Pregnancy Services
IMHO	In my humble opinion
CMF	Cardinal Mindszenty Foundation
IFN	Interferon
PLD	Played
GAL	Get a life
GEA	Gay Educators Association
HRT	Hormone replacement therapy
KDFU	Means Cracking (K) the (D as in Da) *freak* up
AAMCH	American Association of Maternal & Child Health
VD	Venereal disease
IMTM	I am the man
GFWC	General Federation of Women's Clubs
DARE	Dykes Against Racism Everywhere
OEEC	Organization for European Economic Cooperation
ASPEN	American Society for Parenteral and Enteral Nutrition
B/C	Because
ERIS	Exoatmospheric Reentry Intercept System
TMTH	Too much to handle
IEC	Institutional ethics committee
UT2L	You take too long
LI	LinkedIn
TL;DR	Too long; didn't read
PCI	Population Communications International
APCW	Adolescent Pregnancy Childwatch Project
ZC	Zangger Committee
SALT	Strategic Arms Limitation Talks
SFAIK	So far as I know
FACP	Fellow of the American College of Physicians
NAC	Network Action Committee
ABMS	American Board of Medical Specialties
KEYA	I will key you later
FHI	Family Health International
NCJW	National Council of Jewish Women
CICO	Coffee in, coffee out
DARE	Drug Abuse Resistance Education
WATS	Wide Area Telephone System
4AO	For adults only
BAS	Big 'butt' smile
ACE	marijuana cigarette
RTFQ	Read the *freaking* question
DV	Douay Version
BM	Basal metabolism
ICFTU	International Confederation of Free Trade Unions
UHGTBSM	You have got to be s#$t*ing me!
PEN	[International Association of] Poets, Playwrights, Editors, Essayists, and 
RTNTN	Retention (email, Government)
CHSA	Consumer Health Service of America
IOC	International Olympic Committee
PAC	Population Action Council
USCRC	United States Civil Rights Commission
TV-TEST	Transvaginal tubal embryo stage transfer
UNTSO	United Nations Truce Supervision Organization
YHL	You have lost
AISB	As it should be
NCWUS	National Council of Women of the United States
FDA	[United States] Food and Drug Administration
JT (J/T)	Just teasing
CHOICE	Concern for Health Options, Information, Care and Education
BME	Based on my experience
PAF	Platelet-activating factor
H&K	Hugs & kisses
AATB	American Association of Tissue Banks
C	[Degrees] Celsius
YT	You there?
AT	At your terminal
WC	Welcome
G+	Google+
AGA	Alliance of Gay Artists
INTELSAT	International Telecommunications Satellite Organization
WATS	Wide Area Telephone System
SETE	Smiling Ear-to-Ear
WFC	World Food Council
ASRC	Abortion Survivors Rescue Committee
2EZ	Too easy
ICAO	International Civil Aviation Organization
OB	Oh brother
1NAM	One in a million
LLDC	Least developed country
GA	Go ahead
*w*	wink 
HEW	[United States Department of] Health, Education and Welfare
CAM	Camera (SMS)
CB	Coffee break
WAWA	Where are we at?
MHD	Magnetohydrodynamics
IVF-DS	IVF-donor sperm
ME	Menstrual extraction
NLG	National Lawyer's Guild
ISLY	I still love you
CHA	Christian Holiness Association
DH	Dear (or Darling) husband
NS	Nice split
PPFC	Planned Parenthood Federation of Canada
IF	I farted
CWU	Church Women United
JACGUAR	Johns and Call Girls United Against Repression
MAMA	Mothers Against Minor's Abortions
JLC	Juvenile Law Center
k/b	Keyboard
AKA	Also known as
SEO	Search engine optimization
BOAD	Banque Ouest-Africaine de Developpement
IRL	In real life
NLT	No later than
LLS	Laughing like *silly*
HALP	Help (Discord)
POS	Parent over shoulder
SBT	Sorry 'bout that
UCMU	You crack me up
WISC	Washington Interreligious Staff Council
STL	Sacrae theologiae licentiatae
JLMK	Just let me know
POV	Point of View [television program]
HC	House of Commons
YTTL	You take too long
CLK	Click
2M2H	Too much too handle
ACCT	Agence de Cooperation Culturelle et Technique
HIFW	How I felt when... (Used with photo or gif)
NMA	National Medical Association
RAPID	Resources for the Awareness of Population Impacts on Development
GH	Good hand
FOMCL	Falling off my chair laughing
C-PLAN	Communist Party Legislative Action Network
DF	Don't fart
GRNC	Gay Rights National Lobby
SAA	Society for Applied Anthropology
GOBs	Good old boys
RCS	Royal College of Surgeons
NIAAA	National Institute of Alcohol Abuse and Alcoholism
BA	Bad *a*
GSA	Genetics Society of America
CSFC	Committee for the Survival of a Free Congress
ALCON	All concerned
TYT	Take your time
EPA	Environmental Protection Agency
OMG	Oh my God
ALS	Amyotrophic lateral sclerosis
UF	You farted
BIDS	Birth Defects Information System
PISS	Put in some sugar
OIC	Oh, I see
FART	Floor Assistance Rescue Team
404	I don't know
CLC	Campaign Life Coalition
KEYA	I will key you later
F2F	Face to face
BBC	Big bad challenge
W/E	Whatever
VIP	Voter identification project
LQTM	Laughing quietly to myself
ITOP	Induced termination of pregnancy
WTB	Want to buy
CLS	Christian Legal Society
WFAVS	World Federation of Associations for Voluntary Sterilization
NAACP	National Association for the Advancement of Colored People
CYE	Check your e-mail
ROK	Republic of Korea
CID	Crying in disgrace
YOLO	You only live once
NACAC	North American Council on Adoptable Children
F	Fart
OPA	Organ Procurement Agency
2	to in SMS
HLB	Human Life Bill
HAGN	Have a good night
WHCH	White House Conference on Hunger
WIC	Women's International Conference
CIF	Conservation International Foundation
WICCA	Women in Constant Creative Action
NIDA	National Institute on Drug Abuse
SMP	Social Marketing Project
PSOS	Parent standing over shoulder
FUBB	Fouled up beyond belief
COS	Because
USIA	United States Information Agency
YA	Your
PTFO	Pass the *freak* out
2	to in SMS
AFT	American Federation of Teachers
FOLKS	Friends of Little Kids
ETO	Estimated time of ovulation
PDA	Personal display (of) affection
OMS	On my soul (meaning promise)
MERCOSUR	Mercado Comun del Cono Sur
NCPAC	National Conservative Political Action Committee
BOM	*b* of mine
TBT	Throwback Thursday (Twitter slang)
F	[Degrees] Fahrenheit
4	Short for for in SMS
CCBA	Coalition of Concerned Black Americans
VAT	Value added tax
MOD	Moderator
LMBO	Laughing my butt off
AMA	Ask me anything (Reddit)
B&	Banned
YF	Wife
AE	American Education Association
NEA	National Endowment for the Arts
COPE	Committee on Political Education
PMSL	Pee myself laughing
EWTN	Eternal Word Television Network
VM	Voice mail
DLTBBB	Don't let the bed bugs bite
IPS	Institute for Policy Studies
NANA	Not now, no need
2	to in SMS
KK	Okay, Okay!
NPFC	National Pro-Family Coalition
XME	Excuse Me
MFS	Mobilization for Survival
GALAS	Great American Lesbian Art Show
OCD	Order of Discalced Carmelites
HAK	Hug and kiss
BOOMS	Bored out of my skull
FART	Floor Assistance Rescue Team
CLF	Conservation Law Foundation
GPHW	Gay Public Health Workers
FML	*Freak* My Life
1UP	extra life
IRS	Internal Revenue Service
k/b	Keyboard
DNA	Deoxyribonucleic acid
ILUM	I love you man
YD	Yesterday
182	I hate you
NBD	No big deal
SPHA	Solid-phase hemadsorption assay
TBAG	Process of disgracing a corpse, taunting a fragged/killed player
FCI	Family Care International, Inc.
NAS	National Audobon Society
SIMYC	Sorry I missed your call
IF	I farted
AAK	Asleep at keyboard
YGTBKM	You've got to be kidding me
FTW	For the win
PCO	Polycystic ovary syndrome
ATB	All the best
CB	Chat break
143	I love you
IMAP	[International Planned Parenthood Federation] Medical Advisory Board 
O	hugs
RN	Registered nurse
PEACE	People Expressing a Concern for Everyone
DAD	Dads Against Discrimination
JOICFP	Japanese Organization for International Cooperation in Family Planning, 
U-L	You will
NR	Nice roll
AISB	As it should be
YBS	You'll be sorry
NSNA	National Student Nurses Association
CDF	Children's Defense Fund
CPA	Center for Policy Alternatives
WFP	Witness for Peace
CRASH	Center for Reproductive and Sexual Health
LTD	Living the dream
BOM	*b* of mine
IIIO	Intel inside, idiot outside
YGTR	You got that right
AAMOF	As a matter of fact
4	Short for for in SMS
PU	That stinks!
HUYA	Head up your *butt*
SOTMG	Short of time, must go
RHIP	Rank has its privileges
UV	Unpleasant visual
B4N	Bye for now
UNFICYP	United Nations Force in Cyprus
SWMBO	She who must be obeyed. Meaning wife or partner
NAMBLA	North American Man-Boy Love Association
NAJSN	National American Jewish Students Network
KS	Kaposi's Sarcoma
1TG, 2TG	number of items needed for win
NYA	National Youth Administration
IDA	International Development Association
OLL	Online love
ARSC	Abortion Survivors Rescue Committee
PATH	Post-Abortion Trauma Healing
NIROK	Not in reach of keyboard
FIIOOH	Forget it, I'm out of here
HB	Hurry back
BC	Be cool
ESCAP	Economic and Social Commission for Asia and the Pacific
<33	heart or love (more 3s is a bigger heart)
CUL	See you later
CRZ 	Crazy
PACE	Post-Abortion Counseling and Education
DSOC	Democratic Socialist Organizing Committee
DNT	Don't
SP1	Pregnancy-specific beta 1-glycoprotein
D.A.	District attorney
OMI	Oblates of Mary Immaculate
FFP	Friends of Family Planning
GD	Good
FIIK	*Freaked* if I know
CIA	Central Intelligence Agency
WRU	Where are you?
AFMCH	American Foundation for Maternal and Child Health
BGCS	Boyhood Gender Conformity Scale
YCL	Young Communist League
XD	a devilish smile
K	of C Knights of Columbus
14AA41	One for all, and all for one
NVM	Never mind
JSI	John Snow, Inc.
GL2U	Good luck to you
MWAH	kiss (it is is the sound made when kissing through the air)
YCLIU	You can look it up
APC	American Parents Committee
ODC	Order of Discalced Carmelites
NFW	Not for work
NECLU	National Emergency Civil Liberties Committee
BB/BSA	Big Brothers/Big Sisters of America
Buff	changed and is now stronger
BAU	Business as usual
EIB	Excellence in Broadcasting [Network]
W/	With
ACOOG	American College of Osteopathic Obstetricians and Gynecologists
CUL8R	See you later
OOH	Out of here
NOAPP	National Organization on Adolescent Pregnancy and Parenting
W/B	Write back
182	I hate you
UNCTAD	United Nations Conference on Trade and Development
2MORO	Tomorrow
OMAA	Oh, my aching *A* (butt)
CFS	Care for secret?
CU	See you
NE	Any
HHIS	Head hanging in shame
TLK2UL8R	Talk to you later
NFM	None for me / Not for me
BOT	Back on topic
PSS	Peace Science Society
MoD	March of Dimes
LHM	Lord help me
FRCP	Fellow of the Royal College of Physicians, London
PRC	Population Resource Center
CJ	Chief Justice
420	Lets get high
Buff	changed and is now stronger
CTS	Catholic Truth Society
HLA	Human Life Amendment
VWD	Very well done
PTMM	Please tell me more
FFP	Friends of Family Planning
KEWL	Cool
AYEC	At your earliest convenience
TNT	Til next time
BOP	bind on pickup
TIAD	Tomorrow is another day
BF	Boyfriend
IUP	Intrauterine pregnancy
e.g.	Exempli gratia
SIG2R	Sorry, I got to run
EBKAC	Error between keyboard and chair
FUAA	Fathers United Against Abortion
URC	University Research Corporation
MLM	give the middle finger
NFD	National Federation for Decency
G2G	Got to go
IF	I farted
LTNS	Long time no see
HCS	Human chorionic somatomammotropin
VOGUE	Valiant Out Gays United in Energy
CSOW	Commission on the Status of Women
B	Be
MP	Member of Parliament
QSL	Reply 
FIF	*Freak* I'm funny
FWHC	Feminist Women's Health Center
WETSU	We eat this sh_t up
NHI	National Health Insurance
SK8R	Skater
SPST	Same place, same time
GLF	Gay Liberation Front
XME	Excuse Me
A&A	Amniocentesis and abortion
ELI	Environmental Law Institute
NPR	National Public Radio
IF	Intellectual Freedom
LMK	Let me know
L8R	Later
BBT	Basal body temperature
NOPE	National Optimum Population Effort
PSI	Population Services Institute
QT	Cutie
FIF	*Freak* I'm funny
AAUW	American Association of University Women
NCADP	National Coalition to Abolish the Death Penalty
XYZ	Examine your zipper
SRA	Science Research Associates
JLIC	Jewish Life Issues Committee
SAIDS	Simian
ZPG	Zero Population Growth
CPG	Catholic Physicians Guild
QQ (qq) (Q_Q)	crying eyes
SPA-TP	Staphylococcal protein A-IgG
ECOSOC	[United Nations] Economic and Social Council
WAP	Whale Adoption Project
RYB	Read your Bible 
TAT	Tray agglutination test
WEP	Weapon
PI	Private investigator
AISB	As I said before
HIT	Herd of independent thinkers [syndrome]
MOM	Mothers Organized for Morality
GA	Go ahead
ALL	American Life Lobby
ACOG	American College of Obstetrics and Gynecology
CU	Consumer's Union
GRINCH	Gay Retaliation for Inexcusable Negligence and Criminal Homophobia
OECD	Organization for Economic Cooperation and Development
TSC	Teachers Saving Children
MICU	Medical intensive care unit
SCAW	Scientists Center for Animal Welfare
BBA	Balanced Budget Amendment
NRN	No response/reply necessary
WWJD	What would Jesus do?
HTLV	Human T-Cell Lymphotropic Virus
AOYP	Angel on your pillow
FBC	Facebook chat
UNIDO	United Nations International Development Organization
KS	Kill then steal
CAD	Control + Alt + Delete
OSF	Order of St. Francis
MPH	Master of Public Health
HIV	Human immunodeficiency virus
SSA	Social Security Administration
IANAL	I am not a lawyer
MR.(number)	child and his age. Mr.3 would be a 3-year old son
WTFO	What the *freak* ?, over.
ADR	Address
CUL8R	See you later
MKAY	Mmm, okay
QOTD	Quote of the day
WRK	Work
T:)T	Think happy thoughts
ME	Marriage Encounter
BEG	Big evil grin
DYFI	Did you find it?
88	Bye-bye (Mandarin Chinese txt msgs) 
AWMA	American Women's Medical Association
GGE1	Good game, everyone
NCAP	National Community AIDS Partnership
CERN	Conseil Europeen pour la Recherche Nucleaire
G	Giggle
AAMOI	As a matter of interest
CFFC	Catholics' for a Free Choice
SOP	Standard operating procedure
WYCM	Will you call me?
ESF	Economic support funds
IIB	International Investment Bank
DOE	Daughter of Eve
AIFR	American Institute of Family Relations
NCC	National Catholic Coalition
NSNA	National Student Nurses Association
RX	Regards
OCart	Order of Carthusians
HQ	Headquarters
CLS	Critical Legal Studies
H&K	Hugs & kisses
RCAR	'Religious' Coalition for Abortion Rights
IH2F	I have to fart
GALA	Gay Atheists League of America
IRC	Interchange Resource Network
Z%	Zoo
HVH	Heroic Violet Hold
LHSX	Lets have sex
ITT	In This Thread
FBF	Facebook friend
URA*	You are a star
NFPC	National Federation of Priests' Councils
BOHICA	Bend over here it comes again!
LAPAC	Life Amendment Political Action Committee
IVF-SET	IVF-surrogate embryo transfer
APC	American Parents Committee
HAND	Have a nice day
X-1-10	Exciting
JJA	Just joking around
UCMU	You crack me up
ATM	At the moment
AIGHT	Alright
EADB	East African Development Bank
CAP	Committee for American Principles
THX	Thanks
CNN	Cable News Network
<3	broken heart
MSH	Management Sciences for Health
AIH	Artificial insemination
AAUN	American Association of the United Nations
DMNO	Dude Man No Offense
URTM	You are the man
TYVM	Thank you very much
GOP	Grand Old Party
UNA	Use no acronyms
UT2L	You take too long
MOS	Mother over shoulder
QFI	Quoted for idiocy
SU	Shut up
TBL	Text back later
ZZZZ	Sleeping (or bored)
ECLAC	Economic Commission for Latin America and the Caribbean
ICAO	International Civil Aviation Organization
ROFL	Rolling on floor laughing
JP	Jackpot (online gaming, bingo games)
ICEM	Intergovernmental Committee for European Migration
WOC	Women's Ordination Conference
LMAO	Laughing my *a* off
AFC	Away from computer
PST	Pacific Standard Time
PDR	Physicians Desk Reference
ThD	Doctor of Theology
AGP	Association of Gay Psychologists
EYC	Excitable, yet calm
NPC	National People's Congress
AJOG	American Journal of Obstetrics and Gynecology
IKR	I know, right?
NGHC	National Gay Health Coalition
AAR	American Academy of Religion
ARV	AIDS-related virus
GDP	Genome Data Base
SACU	Southern African Customs Union
PLAL	Pro-Life Action League
LMBO	Laughing my butt off
KOC	Kiss on cheek
420	Marijuana
G-77	Group of 77
SF	Someone farted
ZOMG	Used in World of Warcraft to mean OMG (Oh My God)
AOM	Age of Mythology
DoD	Department of Defense
CALC	Clergy & Laity Concerned
BITMT	But in the meantime
GUM	Great unwashed masses
FW	Forward
NBWHP	National Black Women's Health Project
KT	Katie
DTTD	Don't touch that dial
DNT	Don't
MG	Myasthenia Gravis
SRD	Society for the Right to Die
APWU	American Postal Workers Union
URA*	You are a star
INTRAH	[Program for] International Training in Health, University of North 
WUU2	What are you up to?
K	of C Knights of Columbus
URW	You are welcome
OTW	Off to work
SC	Sisters of Charity
?4U	I have a question for you
PC	Personal computer
RTMS	Read the manual, stupid
FC	Fingers crossed
G-77	Group of 77
ILYSM	I love you so much
411	information'
BAE	Before anyone else
411	information
WYHAM	When you have a minute
*s*	smile  
WYWH	Wish you were here
MeSH	Medical subject headings
NICM	National Institute for Campus Ministries
CAD	Short for Canada/Canadian
TTFN	Ta ta for now
OOC	Out of character
ISO	In search of
CSP	Center for Security Policy
HLB	Human Life Bill
BIL	Brother in law
NCA	National Committee for Adoption
AAHS	Americans Against Human Suffering
BF	Boyfriend
AAR	At any rate
FRC	Family Research Council
ILS	International Life Services
SDI	Strategic Defense Initiative
VSF	Very sad face
PITA	Pain in the *butt*
PP	Planned Parenthood
InCAR	International Committee Against Racism
NORD	National Organization for Rare Disorders
AEU	American Ethical Union
CDB	Caribbean Development Bank
LC	Library of Congress
SDAT	Senile Dementia, Alzheimer's Type
AIUM	American Institute of Ultrasound in Medicine
INTERPOL	International Criminal Police Organization
HRU	How are you?
CRA CRA	Slang term meaning crazy
PEP	Promoting Enduring Peace
SSINF	So stupid it's not funny
UPUSA	United Presbyterians USA
LSC	Legal Services Corporation
MMK	okay? (as a question)
IMU	I miss u (you)
UOK	(Are) You ok?
BBS	Be back soon
ROTFL	Rolling on the floor laughing
A/N	Author's note
YCMU	You crack me up
ZH	Sleeping Hour
QQ (qq) (Q_Q)	crying eyes
PLAL	Pro-Life Action Network
SA	Spontaneous abortion
PPU	Pending pick-up
VM	Voice mail
T4BU	Thanks for being you
HMO	Health maintenance organization
FART	Floor Assistance Rescue Team
LAS	League of Arab States
TG	Thank goodness
SLAPP	Strategic lawsuit against public participation
B-DAY	Birthday
DFA	Development Fund for Africa
UNPC	Un- (not) politically correct
MWAH	kiss (it is is the sound made when kissing through the air)
INPLAN	Integrated Population and Development Planning
QSO	Conversation
SOUL	Save Our Unwanted Life
GN	Good night
POM	Public opinion message
AITR	Adult in the room
ACL	American Collegians for Life
PUKS	Pick up kids (SMS)
UNOSOM	United Nations Operation in Somalia
H2CUS	Hope to see you soon
ABT	About
CTN	Can't talk now
FICCL	Frankly I couldn't care a less
HQ	Headquarters
BBIAM	Be back in a minute
RL	Real life
AIM	American Indian Movement
HEW	[United States Department of] Health, Education and Welfare
6Y	Sexy
Feelsbadman	A social meme that means to feel negative.
SEAL	Sea, Air, Land
IUB	Intrauterine occlusion body
TAFN	That's all for now
CCL	Conference for 'Catholic' Lesbians
AAL	American Abolitionist League
MHOTY	My hat (is) off to you
DA	The
LAV	Lymphadenopathy Virus
SIR	Strike it rich
W/O	Without
LTLWDLS	Let's twist like we did last summer
FU	*Freak* you
BRH	Be right here
UOK	(Are) You ok?
N1	Nice one
NCAN	National Coalition of American Nuns
DQMOT	Don't quote me on this
YCL	Young Communist League
RTLC	Right to Life Crusade
BIBO	Beer in, beer out
404	I don't know
CARAL	Canadian Abortion Rights Action League
AANFP	American Academy of Natural Family Planning
ENTA	Norethindrone acetate
TA	Thanks a lot
OLL	Online love
GAS	Greetings and salutations
SAR	Sexual attitude restructuring
ThD	Doctor of Theology
H-FDAY	Happy Father's Day
TA	Transabdominal
CVS	Chorionic Villi Sampling
OPEC	Organization of Petroleum Exporting Countries
B/F	Boyfriend
X-1-10	Exciting
NBAU	No business as usual
CUL	See you later
PPD	Purified protein derivative
WIIFM	What's in it for me?
RRC	Reproductive Rights Coalition
ICAM-1	Intercellular adhesion molecule-1
IV	Intravenous
JFGI	Just *freaking* Google it
TYT	Take your time
SUP	What's up?
ELISA	Enzyme-linked immunosorbent assay
MAP	More Agricultural Production, Inc.
FINRRAGE	Feminist International Network of Resistance to Reproductive and Genetic
TWSS	That's what she said
AA	American Atheists
20	location
IFGR	International Foundation for Genetic Research
ILO0	International Labor Organization
MB	Mamma's boy
WTS	Want to sell?
FRT	For real though
TCB	Take care of business
PTL	Praise the Lord
PVS	Persistent vegetative state
NEP	New Economic Policy
NSCE	National Center for Science Education
IH2F	I have to fart
BIC	Butt in chair
DAFUQ	(What) the *Freak*?
RCAR	'Religious' Coalition for Abortion Rights
SB	Smiling back
NRDA	Natural Resources Defense Association
CIDA	Canadian International Development Agency
ASM	American Society of Mammologists
LH	Luteinizing hormone
TM	Transcendental meditation
QTPI	Cutie pie
ARE	Acronym rich environment
IRCAR	International Reference Center for Abortion Research
AORN	American Association of Registered Nurses
NFD	National Federation for Decency
LEMENO	Let me know
AFDC	American Family Defense Coalition
CWU	Church Women United
NPLD	National Pro-Life Democrats
STW	Search the Web
Y?	Why?
TMB	Text me back
PAPP-A	Pregnancy-associated plasma protein-A
BAG	Busting a gut
YSYD	Yeah sure you do
Msgr	Monsignor
DMPA	Depot-medroxyprogesterone acetate
DFL	Dead *freaking* last
PRON	pornography
TL	Too long
IEP	Inhibin-enriched preparation
UF	You farted
VFW	Veterans of Foreign Wars
FRCS	Fellow of the Royal College of Surgeons, London
UNPROFOR	United Nations ProtectionForce
TTTT	These things take time
RU	Are you?
YNK	You never know
URSKTM	You are so kind to me
DHU	Dinosaur hugs (used to show support)
LNG	Levonorgestrel
PLO	Palestinian Liberation Organization
MPH	Master of Public Health
NAS	National Audobon Society
UNDP	United Nations Development Program
GGU2	Good game, you too
VNH	Very nice hand
EAB	Ethics advisory board
1337	Leet, meaning 'elite'
NCGSTDS	National Coalition of Gay Sexually-Transmitted Disease Services
COS	Because
PI	Population Institute
PTO	Paid time off
FCC	Federal Communications Commission
ERP	Erotic Role-Play
ME	Medical examiner
NFM	Not for me
EWG	Evil wicked grin (in fun, teasing)
BFD	Big freaking deal
E2EG	Ear to ear grin
QSL	Reply 
CUMID	See you in my dreams
ATCC	American Type [Cell] Culture Collection
LAW	Legal Action for Women
KISS	Keep it simple, stupid
IOW	In other words
USPS	United States Postal Service
BFFN	Best friend for now
NACC	North Atlantic Cooperation Council
CS	Christian Science
NICA	National Interfaith Coalition on Aging
PFL	Prayer and Fasting League
PRO	Parents' Rights Organization
OC	Oral contraceptive
HZA	Hemizona assay
PIC	Picture
BGWM	Be gentle with me
BDN	Big darn number
HDL	High-density lipoprotein
SAS	Sisters Against Sexism
EDF	Environmental Defense Fund
ALG	American Lawyer's Guild
IEC	Institutional ethics committee
NCAC	National Coalition Against Censorship
GH	Good hand
RSV	Revised standard version
USU	Usually
WHATEVES	Whatever
ScD	Doctor of Science
d00d	Dude
TPTB	The powers that be
GG	Good Game
AAFP	American Academy of Family Physicians
TFTI	Thanks for the invitation
NHO	National Hospice Organization
SP1	Pregnancy-specific beta 1-glycoprotein
FARM	Farm Animal Reform Movement
BPOE	Benevolent and Protective Order of Elks
USBCA	Until something better comes along
OAPP	Office of Adolescent Pregnancy Programs [United States Department of 
IERA	Inclusive Equal Rights Amendment
IVF-DS	IVF-donor sperm
NCNW	National Council of Negro Women
FWYW	Fart when you want
CMEA	Council for Mutual Economic Assistance
ADDY	Address
ANC	African National Congress
NLSY	National Longitudinal Survey of Youth
TG	Thank goodness
COS	Because
H2CUS	Hope to see you soon
GNITE	Good night
CNP	Continued (in) next post
SWAT	Special Weapons and Tactics
SHID	Slapping head in disgust
ACLA	American Catholic Lawyers Association
WEAL	Women's Equity Action League
HW	Homework
FIF	*Freak* I'm funny
F	female
WNAAC	Women's National Abortion Action Coalition
ISTI	International Science and Technology Institute, Inc.
ERC	Ethical Research Committee
GAL	Get a life
SEAL	Sea, Air, Land
NSGC	National Society of Genetic Counselors
BRNC	Be right back, nature calls
FAB	Fabulous
GPHW	Gay Public Health Workers
PDQ	Pretty damn quick
LCL	League of Catholic Laymen
SMSA	Standard Metropolitan Statistical Area
R	are
GB	Goodbye
EE	Engaged Encounter
DS	Dear (or Darling) son
LLM	Master of Law
CUF	Catholics United for the Faith
APHA	American Public Health Association
EOL	End of lecture
NCAC	National Coalition Against Censorship
WC	Who cares
IUSSP	International Union for the Scientific Study of Population
PIR	Parents in room
EOM	End of message
88	Bye-bye (Mandarin Chinese txt msgs) 
Downvote	Voting negatively on a thread using Reddits voting system (Reddit)
ENUF	Enough
Q4U	(I have a) question for you
Buff	changed and is now stronger
AAHS	Americans Against Human Suffering
AFZ	Acronym Free Zone
ADMIN	Administrator
YGG	You go girl
DIKU	Do I know you?
10X	Thanks
AIM	American Indian Movement
NIROK	Not in reach of keyboard
CRZ 	Crazy
H.J.R.	House Joint Resolution
PBS	Public Broadcasting System
NWM	New Ways Ministry
IDDS	Institute for Defense & Disarmament Studies
ETA	Estimated time (of) arrival
UDS	Ugly domestic scene
SWAK	Sent (or sealed) with a kiss
FAY	*Freak* all you
GMC	General Medical Council
SUZI	Sub-zonal insemination
EOS	End of show
SAT	Scholastic Aptitude Test
1337	Leet, meaning 'elite'
CEDPA	Centre for Development and Population Activities
ICGI	International Conference on Gender Identity
ED	Erase display
HCG	Human chorionic gonadotrophin
TUI	Turning you in
SJ	Society of Jesus
IDBI	I don't believe it
DF	Don't fart
GMTA	Great minds think alike
j00r	Your
BOT	Back on topic
BAG	Busting a gut
CFA	Committee for Future America
SDC	Social Development Center
IOM	International Organization for Migration
LBAY	Laughing back at you
G2R	Got to run
555	Sobbing, crying. (Mandarin Chinese txt msgs)
BM	Bite me
CB	Coffee break
W3	WWW (Web address)
1NAM	One in a million
SIR	Strike it rich
TOTES	Totally
FYEO	For your eyes only
555	Sobbing, crying. (Mandarin Chinese txt msgs)
XD	really hard laugh (where D is a smiley mouth)
SJD	Doctor of Juridical Science
WL	Whatta loser
IWSN	I want sex now
BFG	Big  freaking grin
CMA	Catholics for a Moral America
KOTC	Kiss on the cheek
CCL	Couple to Couple League
NCSW	National Conference on Social Welfare
GORK	God only really knows
ECOSOC	Economic and Social Council
UNIFEM	United Nations Development Fund for Women
OTA	Office of Technology Assessment
ZZZZ	Sleeping (or bored)
NCTE	National Council of Teachers of English
NRDC	National Resource Defense Council
KROW	Keep Rockefeller out of Washington
ASHA	American Social Health Association
MIA	Missing in action
BCFA	Birth Control Federation of America
INS	Immigration and Naturalization Service
LERK	Leaving easy reach of keyboard
UX	User experience
CSCPA	Committee for Social Change and Political Action
CRA CRA	Slang term meaning crazy
C&G	Chuckle & grin
MLM	give the middle finger
MSW	Master of Social Work
GOBs	Good old boys
BUBU	Slang term for the most beautiful of women
WTFO	What the *freak* ?, over.
WOOMB	World Organization of the Ovulation Method Billings
UNFICYP	United Nations Force in Cyprus
GUD	Good 
WWI	Worldwatch Institute
USSR/EE	USSR/Eastern Europe
ACF	Americans for Constitutional Freedom
C&G	Chuckle & grin
VGH	Very good hand
<33	heart or love (more 3s is a bigger heart)
WCCL	Wisconsin Citizens Concerned for Life
JW	Jehovah's Witness
ALADI	Asociacion Latinoamericana de Integracion;
GNSD	Good night, sweet dreams
20	location
UL	Upload
NCADV	National Coalition Against Domestic Violence
121	One-to-one (private chat initiation)
NFPRHA	National Family Planning and Reproductive Health Association
FYA	For your amusement
FCAA	Florence Crittenden Association of America
IMAO	In my arrogant opinion
GI	Government issue
LIC	Like I care
PRB	Population Reference Bureau
NWHN	National Women's Health Network
YW	You're welcome
SPR	Society for Psychical Research
LLLI	La Leche League International
IFCA	International Federation of Catholic Alumnae
YABA	Yet another bloody acronym
SJW	Social justice warrior
WYSIWYG	What you see is what you get 
IMU	I miss u (you)
IWAWO	I want a way out
WHCCY	White House Conference on Children and Youth
CFC	Chlorofluourocarbons
TURNT	Turn up
NFM	Not for me
L8RG8R	Later, gator
CCF	Cooperative Commonwealth Federation
SIM	Simian Immunodeficiency Virus
SOS	help
CHD	Campaign for Human Development
CTO	Check this out
WFS	World Fertility Survey
PFL	Prayer and Fasting League
PROGGY	computer program
OERI	Office of Educational Research and Improvement
CIS	Center for Inter-American Security
LII	Life Issues Institute
PRO	Parents' Rights Organization
UTM	You tell me
CYO	See you online
CE	Council of Europe
TBL	Text back later
NASW	National Association of Social Workers
MM	Moral Majority
GI	Girls Incorporated
FOI	Freedom of Information [Act]
M$	Microsoft
RNC	Republican National Committee
TGIF	Thank God it's Friday
DF	Don't fart
JIC	Just in case
2NTE	Tonight
BOYF	Boyfriend
ADAD	Another day, another dollar
SD	Standard deviation
FRC	Family Research Council
IFC	International Finance Corporation
FPA	Family Protection Act
JCL	Licentiate in Canon Law
HNL	(w)Hole 'nother level
CALM	Custody Action for Lesbian Mothers
EBRD	European Bank for Reconstruction and Development
ISO	In search of
ET	Embryo transfer
CCD	Confraternity of Christian Doctrine
*w*	wink 
^URS	Up yours
CEMA	Council for Mutual Economic Assistance
CIV	Cultures, ideas and values [course]
NEH	National Endowment for the Humanities
RT	Roger that
EC	Evangelicals Concerned
LSV	Language, sex and violence
ACTH	Adrenocorticotropic hormone
D&C	Dilatation and curettage
G2TU	Got to tell u (you)
PMS	Pre-menstrual syndrome
NPR	National Public Radio
NCCY	National Committee for Children and Youth
OMDB	Over my dead body
FLS	Front Line States
DAP	Dial-a-porn
OM	Old man
NE1	Anyone
WFC	World Food Council
4EAE	Forever and ever 
ATEOTD	At the end of the day
POC	Prisoners of conscience
IAEA	International Atomic Energy Agency
ACA	Arms Control Association
DA	The
CARAL	California Abortion Rights Action League
K8T	Katie
TV-TEST	Transvaginal tubal embryo stage transfer
KEYME	Key me when you get in
BIDS	Birth Defects Information System
FUBAR	Fouled up beyond all recognition
CLC	Clergy and Laity Concerned
DAV	Disabled American Veterans
BAS	Big 'butt' smile
SIS	sister
OB	Oh baby
KOTC	Kiss on the cheek
IIED	International Institute for Environment and Development
ABA	American Booksellers' Association
IRBM	Intermediate Range Ballistic Missile
AEAP	As early as possible
ICD	Intracervical device
404	I don't know
ICGI	International Conference on Gender Identity
UNFPA	United Nations Fund for Population Activities
IH2F	I have to fart
CDL	Citizens for Decency Through Law
CLS	Christian Legal Society
APA	American Psychological Association
AMFAR	American Foundation for AIDS Research
AYT	Are you there?
WK	Week
DLBBB	Don't let (the) bed bugs bite
ADRDAA	Alzheimer's Disease and Related Disorders Association
FC	Full card
2G2BT	Too good to be true
NAAPC	National Association for the Advancement of Preborn Children
APA	American Psychiatric Association
Xn	Christian
IB	I'm back
IFYP	I feel your pain
2B	To be
G4C	Going for coffee
TLC	Tender loving care
ABT2	About to'
GI	Government issue
USSR	Union of Soviet Socialist Republics
ALF	Animal Liberation Front
*s*	smile  
ABU	All bugged up
MISS.(number)	child and her age. Miss.3 would be a 3-year old daughter
BSF	But seriously folks
DSM	Diagnostic and Statistical Manual
OT	Ovum transfer
LIC	Like I care
YD	Yesterday
AFLM	Advocates for Life Ministries
MC	Merry Christmas
VBS	Very big smile
MC	Member of Congress
WLDF	Women's Legal Defense Fund
PNAP	Prolife Nonviolent Action Project
CRA CRA	Slang term meaning crazy
ARG	Argument
JW	Just wondering
WCF	Women's Campaign Fund
PCM	Please call me
STM	Sacrae theologiae masterieus
IBRC	Infant Bioethical Review Committee
DEEZ NUTZ	A phrase used in online chat to annoy or frustrate those involved in the conversation.
NCFA	National Committee for Adoption
WAT	What
IFAD	International Fund for Agricultural Development
QIK	Quick
LDC	Less-developed country
H8	Hate
BLNT	Better luck next time
AAA	American Adoption Agency
AMEN	AIDS in Multi-Ethnic Neighborhoods Study
HLI	Human Life International
WAA	Women's Action Alliance
IMSB	I am so bored
THNQ	Thank-you (SMS)
URSKTM	You are so kind to me
BSCS	Biological Sciences Curriculum Study
INTERPOL	International Criminal Police Organization
HC	House of Commons
GRID	Gay-Related Immune Deficiency
FBB	Facebook buddy
AAMOF	As a matter of fact
NAZI	Nationalen Socialisten
OI	Operator indisposed
WFTU	World Federation of Trade Unions
TDTM	Talk dirty to me
AGA	American Genetic Association
NARHC	National Association of Reproductive Health Centers
A3	Anytime, anywhere, anyplace
BSTS	Better safe than sorry
UNBLEFBLE	Unbelievable
BFFN	Best friend for now
CP	Colombo Plan
SOMY	Sick of me yet?
Xn	Christian
Feelsbadman	A social meme that means to feel negative.
NARRAL	National Abortion and Reproductive Rights Action League
FB	Facebook
PWN	own
NAAF	National Association for Abortion Facilities
ACDNT	Accident (e-mail, Government)
FBF	Flashback Friday
SUL	See you later
9	Parent is watching 
FOE	Fraternal Order of Eagles
AsDB	Asian Development Bank
S4L	Spam for life
ISTI	International Science and Technology Institute, Inc.
TAT	Tray agglutination test
NCJW	National Council of Jewish Women
R8	Rate (SMS)
MBS	Mom behind shoulder
Feelsbadman	A social meme that means to feel negative.
CBA	Christian Booksellers Association
SRA	State's Rights Amendment
GNP	Gross national product
GTFOH	Get the *freak* outta here
CHEER	Center for Homosexual Education, Evaluation and Research
FU	*Freak* you
MIM	Morality in Media
HDL	High-density lipoprotein
NEW	Network of Empowered Women
AFAIC	As far as I am concerned
LULZ	joke, or for laughs
A/S/L	Age/sex/location
HAGN	Have a good night
IMPACT	Innovative Materials for Population Action
K	Okay
4EVA	Forever
KEYME	Key me when you get in
G	Grin
HLI	Human Life International
BS	Bachelor of Science
CLK	Click
HAWT	sexy or attractive
411	information
AIR	As I remember
AFK	Away from keyboard
AMOS	Assumptions are the mother of all screwups
ROTC	Reserve Officers Training Corps
AWOL	Absent without leave
GIAR	Give it a rest
WP	Warsaw Pact
MIRL	Meet in real life
LLB	Bachelor of Law
RLY	Really
BAMF	Bad *a* mother *f*
SFRY	Socialist Federal Republic of Yugoslavia
UNOS	United Network for Organ Sharing
ACNM	American College of Nurse-Midwives
CEO	Chief executive officer
SP1	Pregnancy-specific beta 1-glycoprotein
YARLY	Ya, really?
DM	Do me
CMON	Come on
G4C	Going for coffee
1UP	extra life
DF	Don't fart
TANKED	owned
ABT2	About to'
1UP	extra life
PLO	Palestinian Liberation Organization
DF	Don't even go there
ARC	AIDS-Related Complex
ASHG	American Society of Human Genetics
FIL	Father in law
ACE	American Council on Education
KTF	Keep the Faith
PHWFL	Public Health Workers for Life
B4	Before
RTHX	Thanks for the RT (Retweet) (Twitter slang)
UNIFIL	United Nations Interim Force in Lebanon
K	of P Knights of Pythias
NIE	Newly industrializing economy
HF	Have fun
GNA	Good night all
GOI	Get over it
GR&D	Grinning, running and ducking
WAS	Wild *a* guess
CM-BBT	Cervical Mucus-Basal Body Temperature
FCOL	For crying out loud
SDS	Students for a Democratic Society
ABBR	abbreviation
DINK	Double-income, no kids
MX	Missile, experimental
DRG	Diagnosis-related group
BRT	Be right there
<33	heart or love (more 3s is a bigger heart)
RU	Roussel-Uclaf
B9	Boss is watching
NVR	Never
AFC	Apostolate for Family Consecration
ABC	Already been chewed
CWLA	Child Welfare League of America
JS&A	John Short & Associates, Inc.
SUP	What's up?
HFAC	Holy flipping animal crackers
DLTBBB	Don't let the bed bugs bite
BR	Best regards
EPH	Edema/proteinuria/hypertension
JAS	Just a second
EVA	Ever
DNC	Do not compute (meaning I do not understand)
GPOY	Gratuitous picture of yourself
IGN	I (I've) got nothing
YTG	You're the greatest
ROC	Republic of China
AANP	American Academy of Nurse Practitioners
2MORO	Tomorrow
SYY	Shut your yapper
MYOB	Mind your own business
UN4TUN8	Unfortunate
PIH	Pyridoxal isonicotinoyl hydrazone
ADBB	All done, bye-bye
W@	What?
TMI	Too much information
20	location
BORN	Bi-State Operation Rescue Network
TSNF	That's so not fair
NCCB	National Council of Catholic Bishops
UF	You farted
SUL	See you later
1DR	I wonder
QN	Queer Nation
DORBS	Adorable
PRT	Party
APA	American Pharmaceutical Association
BF2	Battlefield 2
APP	Appreciate
DNA	Deoxyribonucleic acid
FART	Floor Assistance Rescue Team
HAG1	Have a good one
TTYL	Talk to you later
19	Zero hand
YHBT	You have been trolled
AYTMTB	And you're telling me this because
NWF	National Wildlife Federation
DM	Deutsche Mark
DSS	Delayed Shock Syndrome
A/N	Author's note
IYSS	If you say so
NFL	National Federation for Life
RG	Rio Group
SIS	Snickering in silence
WHO	World Health Organization
BVM	Blessed Virgin Mother
PKMN	Pokemon
BCNU	Be seeing you
CODEL	Coordination in Development
BN	Bad news
ESAD	Eat *S* and die!
SSINF	So stupid it's not funny
OR	Operation Rescue
SSIF	So stupid it's funny
GTA	Gay Theatre Alliance
IMCO	Intergovernmental Maritime Consultative Organization
NFW	Not for work
RHIP	Rank has its privileges
F	Fart
4EVA	Forever
LARFPC	Los Angeles Regional Family Planning Council
CEPGL	Communaute Economique des Pays des Grands Lacs
PDA	Personal display (of) affection
GDR	German Democratic Republic
ATSL	Along the same line (or lines)
PAA	Population Association [or Assistance] of America
CDF	Children's Defense Fund
O4U	Only for you
YWCA	Young Women's 'Christian' Association
HDDA	Humane and Dignified Death Act
AOM	Age of majority
CHK	Check
WLNC	Women's Leadership Network Conference
T.O.P.	[Dominican] Third Order of Penance
NERF	Changed and is now weaker
PHS	[United States] Public Health Service
DORBS	Adorable
IUSS	If you say so
EZY	Easy
JCB	Bachelor of Canon Law
IOMH	In over my head
GPO	[United States] Government Printing Office
MR.(number)	child and his age. Mr.3 would be a 3-year old son
HBD	Happy birthday
FBI	Federal Bureau of Investigation
LOL	Laugh out loud
DMY	Don't mess yourself
NSW	New South Wales
PROLLY	Probably
WFF	Women for Faith and Family
IF	I farted
PTO	Parent Teacher Organization
AAI	Alternatives to Abortion International
CU	See you
PLU	People like us
CDI	Center for Defense Information
SAR	Sexual attitude restructuring
WGACA	What do you think?
NSC	National Security Council
UAW	United Auto, Aircraft, and Agricultural Implements Workers of America
ETA	Edited to add
NOEL	National Organization of Episcopalians for Life
ES	Erase screen
CSsR	Congregatio Sanctissimi Redemptoris
ACCT	Agence de Cooperation Culturelle et Technique
VFW	Veterans of Foreign Wars
PIP	Population Information Program, Johns Hopkins University
SDMB	Sweet dreams, my baby
7K	Sick
CURLO	See you around like a donut
BWS	Better World Society
AFSC	American Friends Service Committee
CW	Conventional wisdom
SUX	Meanings sucks or it sucks
FOA	Field operating activity
FZ	Franc Zone
AWESO	Awesome
CRB	Come right back
BA	Bad *a*
CHCE	Center for Health Care Ethics
SELFIE	A photo that is taken of oneself for social media sharing (definition)
MS	Master of Science
WETSU	We eat this sh_t up
TFRI	Transnational Family Research Institute
JCHA	Joint Committee of Hospital Associations
YG	Young gentleman
2G2BT	Too good to be true
YCMU	You crack me up
QT	Cutie
EKG	Electrocardiogram
ARV	AIDS-related virus
NWA	Niggers With Attitude
YR	Yeah right
ECO	Economic Cooperation Organization
DA	The
MCCL	Minnesota Citizens Concerned for Life
CAD	Short for Canada/Canadian
SUITM	See you in the morning
GAU	Gay Academic Union
CYO	See you online
RX	drugs or prescriptions
GLSA	Gay Law Students Association
NQT	Newly qualified teacher
C-PLAN	Communist Party Legislative Action Network
G2GICYAL8ER	Got to go I'll see you later
CONRAD	Contraceptive Research and Development Program, Eastern Virginia 
BAE	Babe or baby
H8	Hate
BORN	Bi-State Operation Rescue Network
TSC	Teachers Saving Children
WIU	Wrap it up
SOP	Standard operating procedure
ZZZZ	Sleeping (or bored)
LY	Love ya 
NBPTS	National Board for Professional Teaching Standards
ALL	American Life Lobby
ICAM-1	Intercellular adhesion molecule-1
MA	Master of Arts
NMU	Not much, you?
420	Marijuana
IAAA	I am an accountant
TRO	Temporary restraining order
STOPP	Stop Planned Parenthood
NORC	National Opinion Research Center
NFS	National Fertility Study
IMAP	[International Planned Parenthood Federation] Medical Advisory Board 
XME	Excuse Me
AFAIC	As far as I am concerned
FOR	Fellowship of Reconciliation
ProPAC	Progressive Political Action Committee
FUTAB	Feet up, take a break
ASHG	American Society of Human Genetics
OSA	Order of St. Augustine
OO	Over and out
RTI	Research Triangle Institute
DW	Dear (or Darling) wife
TY	Thank you
BB	Big brother
LOLO	Lots of love
DPA	Durable power of attorney
BCOS	Because
GAS	Gay Alliance of Students
2N8	Tonight
COMECON	Coordinating Committee on Export Controls
OP	On phone
LLD	Doctor of Law
B/F	Boyfriend
555	Sobbing, crying. (Mandarin Chinese txt msgs)
<3	sideways heart (love, friendship)
ACC	Arab Cooperation Council
LOL	Laughing out loud
AI	Artificial intelligence
PRON	pornography
SUX	Meanings sucks or it sucks
IMAO	In my arrogant opinion
ENTA	Norethindrone acetate
TAU	Thinking about u (you)
ZH	Sleeping Hour
CAD	Short for Canada/Canadian
KNOW	knowledge
POAHF	Put on a happy face
BBIAB	Be back in a bit
W/O	Without
OSB	Order of St. Benedict
SITD	Still in the dark
ECOWAS	Economic Community of West African States
NHS	National Health Service
SA	Salvation Army
VBL	Visible bra line
TMB	Text me back
USCSC	United States Civil Service Commission
DCL	Doctor of Canon Law
RTHX	Thanks for the RT (Retweet) (Twitter slang)
S2S	Sorry to say
TFTT	Thanks for this tweet (Twitter slang)
FF	Follow Friday (Twitter slang)
FML	*Freak* My Life
NADT	Not a darn thing
LMMFAO	Laughing my mother freaking a** off
MOOS	Member of the opposite sex
FSP	Fallopian tube sperm perfusion
B2C	Business-to-consumer
NDA	New drug application
GORK	God only really knows
SMEXI	Combination of sexy and Mexican, used to describe attractive people
D2	Dedos / fingers (Spanish SMS)
XYZ	Examine your zipper
XD	really hard laugh (where D is a smiley mouth)
WAT	What
SQ	Square
KI	Karyopyknotic index
AL	Arab League
NEW	Network of Empowered Women
ICC	International Chamber of Commerce
DMPA	Depot-medroxyprogesterone acetate
SA	Sexaholics Anonymous
DBP	Defense Budget Project
UNPC	Un- (not) politically correct
BDAY	Birthday
BFFLNMW	Best friends for life, no matter what
AATK	Always at the keyboard
OMAA	Oh, my aching *A* (butt)
AVA	American Victims of Abortion
CYO	See you online
PDH	Pretty darn happy
ABC	American Broadcasting Company
WAS	Wild *a* guess
OGIM	Oh God, it's Monday
APP	Appreciate
SK8	Skate
QFI	Quoted for irony
BYTM	Better you than me
DUR	Do you remember?
BOB	Back off *buddy*
BA	Bachelor of Arts
ABTA	Good-bye (signoff)
WTS	Want to sell?
CYAL8R	See you later
UNDP	United Nations Development Program
BMA	British Medical Association
TOTES	Totally
MSI	Marie Stopes International
TYAFY	Thank you and *freak* you
SWAT	Scientific wild *butt* guess
IRNFP	International Review of Natural Family Planning
ABU	All bugged up
DGTG	Don't go there, girlfriend
CPS	Current Population Surveys
LH6	Lets have sex
OSM	Order of the Servants of Mary
TTG	Time to go
UNMOGIP	United Nations Military Observer Group in India and Pakistan
BELF	Blood Elf
SOS	Secular Organization for Sobriety Societies
PC	Player character
CLW	Council for a Livable World
NCE	New Catholic Edition
GBS	Gay bowel syndrome
MP	Mana points
TIL	Today I learned
FEHB	Federal Employee's Health Benefits
N2M	Nothing too much
ICJ	International Court of Justice
FRG	Federal Republic of Germany
NACHO	North American Conference of Homophile Organizations
NGO	Non-governmental organization
WWJD	What Would Judd Do? (Artist Donald Judd, who was known to do things in his own compulsive way.)
PD	Peak day
1337	Leet, meaning 'elite'
GTRM	Going to read mail 
IHS	Indian Health Service
THNQ	Thank-you (SMS)
AAP	American Academy of Pediatrics
B8	Bait (person teased or joked with, or under-aged person/teen)
SAA	Society for Applied Anthropology
CRBT 	Crying really big tears 
SF	Someone farted
ARMS	Abortion-Related Ministries
Z	Said
SMP	Social Marketing Project
AT	At your terminal
AH	At home
1DR	I wonder
FWP	First world problems
ACW	Action for World Community
UPUSA	United Presbyterians USA
PDW	People's Daily World Magazine
X	Kiss
CED	Committee for Economic Development
FCC	Federal Council of Churches
QIK	Quick
WHCA	White House Conference on Aging
D/L	Download
4COL	For crying out loud
FPA	Family planning associates
STD	Sacrae theologiae doctor
PAHO	Pan American Health Organization
ITYK	I thought you knew
WMO	World Meteorological Organization
GTA	Gay Theatre Alliance
PND	Prenatal diagnosis
ICBW	It could be worse
IMO	In my opinion
55555	Crying your eyes out (Mandarin Chinese txt msgs)
VN	Very nice
LORCS	League of Red Cross and Red Crescent Societies
O	Opponent
P2P	Pay to play
VOC	Victims of Choice
ITEST	Institute for Theological Encounter With Science and Technology
UUA	Unitarian Universalist Association
CMGR	Community manager
EMBAR	Embarassing
PMFI	Pardon me for interrupting
DORBS	Adorable
OAS	Organization of American States
R	are
PMSL	Pee myself laughing
DNR	Dinner (SMS)
CIN	Cervical intraepithelial neoplasia
ATSITS	All the stars in the sky
DOT	Damage over time
WUU2	What are you up to?
AVDP	Avoirdupois
BF	Brain fart
AAP	Always a pleasure
TFR	Total fertility rate
WEEBO	Describes a person obsessed with of Japanese culture
TOY	Thinking of you
T.O.P.	[Dominican] Third Order of Penance
WRUD	What are you doing?
RYS	Are you single?
COH	City of Heroes
CERES	Center for Research in Education and Sexuality
TMOT	Trust me on this
F	[Degrees] Fahrenheit
POV	Point of view
PBOOK	Phonebook (e-mail)
XLNT	Excellent 
TBA	To be announced
ROFL	Rolling on floor laughing
AIH	Artificial insemination
PDQ	Pretty damn quick
LMFAO	Laughing my freaking *a* off
TTAPS	Toon, Turco, Ackerman, Pollack, and Sagan
FART	Floor Assistance Rescue Team
420	Marijuana
GBU	God bless you
DUPE	Duplicate
Facepalm	Used to represent the gesture of smacking your forehead with your palm to express embarrassment or frustration
NEA	National Education Association
RCP	Revolutionary Communist Party [of the U.S.]
FBOW	For better or worse
WPC	World Population Council
BYTM	Better you than me
BBIAS	Be back in a sec
NORML	National Organization for the Repeal of Marijuana Laws
j00	You
WIBNI	Wouldn't it be nice if
ROK	Republic of Korea
LLLI	La Leche League International
SF	Someone farted
BME	Based on my experience
POC	Products of conception'
AOTA	All of the above
OM	Ovulation method
CNS	Committee for National Security
WOMBAT	Waste of money, brains and time
UPC	United Pro-Life Council
PPL	People
2M2H	Too much too handle
ODC	Order of Discalced Carmelites
CLC	Campaign Life Coalition
PPL	Presbyterians Pro-Life
UPS	Uterine progesterone system
WYWH	Wish you were here
NWO	No way out
OG	Original gangster
NMA	National Medical Association
PK	Psychokinesis
OSV	Our Sunday Visitor [Magazine]
SDC	Social Development Center
IRLF	International Right to Life Foundation
NSG	Nuclear Suppliers Group
CONUS	Continental United States
IDTS	I don't think so
SAS	Sisters Against Sexism
CARR	Coalition Against the Radical Right
TFTF	Thanks for the follow (Twitter slang)
EMA	E-mail address (Twitter slang)
ACP	African, Caribbean, and Pacific Countries
UFN	Until further notice
DM	Dungeon Master
FCI	Family Care International, Inc.
UCMU	You crack me up
ICEA	International Childbirth Education Association
PI	Pearl Index
PMS	Pre-menstrual syndrome
UR2YS4ME	You are too wise for me
INSERM	Institut National de la Sant:e et de la Recherche Medicale
JDI	Just do it
WAP	Women Against Pornography
AIR-PLUS	American Information Route Toward a Pro-Life United States
ZH	Sleeping Hour
SELA	Sistema Economico Latinoamericana
PATH	Program for Appropriate Technology in Health
SBC	School-based clinic
FBI	Federal Bureau of Investigation
GDR	German Democratic Republic
MD	Medical doctor
CIAO	Good-bye (Italian word)
NEET	Nafarelin European Endometriosis Trial Group
LTL	Laparoscopic tubal ligation
PAC	Political action committee
EIS	Environmental impact statement
KOTL	Kiss on the lips
CE	[International Society of] Christian Endeavor
M8	Mate
DOM	Deo optimo maximo
CIS	Center for Inter-American Security
CBC	Canadian Broadcasting Corporation
MUAH	Multiple unsuccessful attempts (at/to) humor
LTL	Laparoscopic tubal ligation
GGMSOT	Gotta get me some of that
DQMOT	Don't quote me on this
PLAL	Pro-Life Action League
411	information'
CPS	Contraceptive Prevalence Surveys
IVIG	Intravenous immunoglobulin
IF	I farted
GGP	Got to go pee
SRD	Society for the Right to Die
DSS	Delayed Shock Syndrome
CIDA	Canadian International Development Agency
FEBS	Federation of European Biochemical Societies
OTC	Over the counter
ETA	Estimated time (of) arrival
FBO	Facebook official (An official update from Facebook)
BCR	Benefit-cost ratio
GAO	General Accounting Office
ELI5	Explain like I'm 5
AMBW	All my best wishes
CASE	Christian Advocates Serving Evangelism
HIRE	Hooking is Respectable Employment
BDN	Big darn number
USMC	United States Marine Corps
FTFY	Fixed that for you
LEAD	League for Economic Assistance and Development
HUGO	Human Genome Organization
MU	Miss U (you)
GIC	Gift in crib
OYO	On your own
FART	Floor Assistance Rescue Team
CEMA	Council for Mutual Economic Assistance
AE	Area effect
IOM	International Organization for Migration
EOL	End of life
SSSS	Society for the Scientific Study of Sex
IBRD	International Bank for Reconstruction and Development
AE	Area effect
AOA	American Orthopsychiatric Association
GMBA	Giggling my butt off
TMA	Take my advice
CFR	Code of Federal Regulations
BYOP	Bring your own paint (paintball)
IDK	I don't know
Cakeday	Birthday (Reddit)
CTW	Children's Television Network
AEI	American Enterprise Institute
PSYOPS	Psychological operations
ICM	Intergovernmental Committee for Migration
TMI	Too much information
ASEAN	Association of Southeast Asian Nations
TANK	really strong
j00	You
MINURSO	United Nations Mission for the Referendum in Western Sahara
TYS	Told you so
URA*	You are a star
NCHA	National Council on Higher Education
FIAMC	International Federation of Catholic Medical Associations
CAH	Congenital adrenal hyperplasia
LTS	Laughing to self
MTF	More to follow
NRL-PAC	National Right to Life Political Action Committee
CU	See you too
PLAN	Plan Loving Adoption Now
UMC	United Methodist Church
ARF	Animal Rights Front
CMA	Catholics for a Moral America
MOD	Modification
ScD	Doctor of Science
SK8RBOI	Skater Boy
NFWS	Not for work safe
AMU	Arab Maghreb Union
ASHS	Association of Secular Humanist Societies
JSD	Doctor of Juristic Science
BFF	Best friends forever
NBFAB	No bad for a beginner
WMA	World Medical Association
YCHT	You can have them
2EZ	Too easy
W8	Wait
WTM	Who's the man?
9	Parent is watching 
JPSA	Joint Program for the Study of Abortion
SM	Society of Mary
RYS	Read your screen 
FOCA	Freedom of Choice Act
CHILD	Christians Helping in Life's Defense
ESA	European Space Agency
DARE	Dykes Against Racism Everywhere
CFS	Care for secret?
AYTMTB	And you're telling me this because
ICU	Intensive care unit
LIFE	Life Issues in Formal Education
2G2BT	Too good to be true
FSA	Family Service Association
K	of P Knights of Pythias
AI	Artificial insemination
HSA	Health Systems Agencies
RYS	Are you single?
DTS	Don't think so
DM	Direct message (Twitter slang)
HRT	Hormone replacement therapy
UFB	Un *freaking* believable
NHS	National Health Service
UF	You farted
CCPA	Catholics for Christian Political Action
UR2YS4ME	You are too wise for me
WUCIWUG	What you see is what you get
SIDS	Sudden Infant Death Syndrome
OAPEC	Organization of Arab Petroleum Exporting Countries
Z	Zero
MOD	Moderator
K	Okay
SCI-COP	Committee for the Scientific Investigation of Claims of the Paranormal
CFD	Concern for Dying
4	Short for for in SMS
LSV	Language, sex and violence
EIS	Environmental impact statement
ACT-UP	AIDS Coalition to Unleash Power
VNH	Very nice hand
B2B	Business-to-business
AFPOE	A fresh pair of eyes
KOS	Kill on sight
CAEU	Council of Arab Economic Unity
RICO	Racketeering-Influenced Corrupt Organizations Act
RSCJ	Religious of the Sacred Heart of Jesus
D&E	Dilatation and evacuation
OPR	Office of Population Research, Princeton University
10X	Thanks
20	location
CAP	Children Awaiting Parents
10Q	Thank you
NINA	No Irish need apply
SMH	Shaking my head
AKA	Also known as
KISS	Keep it simple, stupid
KK	Knock, knock
ISO	International Organization for Standardization
X!	a typical woman
WGACA	What do you think?
AFFA	Angels Forever, Forever Angels
AMA	American Medical Association
CRA	Center for Reproductive Alternatives
RUMOF	Are you male or female?
CPFH	Center for Population and Family Health, Columbia University
UCS	Union of Concerned Scientists
NAM	New American Movement
WDALYIC	Who died and left you in charge
ALI	American Liberties Institute
BAFO	Best and final offer
VWP	Very well played
SPA-TP	Staphylococcal protein A-IgG
PIE	Paedophiliac International Exchange
PZA	Pizza
OS	Operating system
LLDC	Least developed country
PRO	Public relations officer
BBL	Be back later
GnRHa	Gonadotrophin-releasing-hormone analogue
AAF	As a matter of fact
BAD	Banque Africaine de Developpement [African Development Bank 
AA	Alcoholics Anonymous
ARC	Archive (compressed files)
JS&A	John Short & Associates, Inc.
CRW	Council of Religious Women
TOU	Thinking of you
420	Marijuana
AYSOS	Are you stupid or something?
YAA	Yet another acronym
MHD	Magnetohydrodynamics
NWPC	National Women's Political Caucus
LIMT	Laugh in my tummy
LCL	League of Catholic Laymen
FFLA	Feminists for Life of America
XOXOXO	Hugs & Kisses
WYD	What (are) you doing?
UDM	U (You) da (the) man
SD	Senile dementia
BCS	Bethany Christian Services
VVF	Vesico-vaginal fistula
NERPRC	New England Regional Primate Research Center
511	Too much information (more than 411)
CURLO	See you around like a donut
OATUS	On a totally unrelated subject
IYO	In your opinion
ARHO	Association of Reproductive Health Officials
TBAG	Process of disgracing a corpse, taunting a fragged/killed player
MERCOSUR	Mercado Comun del Cono Sur
DF	Don't fart
RUT	Are u (you) there?
PDH	Pretty darn happy
ST&D	Stop texting and drive
NM	Nice meld
ERS2	Eres tz / are you (Spanish SMS)
G7	Group of Seven
Feelsbatman	A social meme taking feelsbadman to the extreme. This references the DC super hero Batmanbecause he witnessed the murder of his parents.
CEP	Council on Economic Priorities
BAM	Below average mentality
BBB	Better Business Bureau
Op	cit Opere citato
BAU	Business as usual
MORF	Male or female?
PMFI	Pardon me for interrupting
AO	Anarchy Online
DYNWUTB	Do you know what you are talking about?
WVSC	Water vacuum suction curettage
ONUSAL	United Nations Observer Mission in El Salvador
SCUM	Society for Cutting Up Men
MPA	Medroxyprogesterone acetate
TYSO	Thank you so much
OMB	Office of Management and Budget
SJ	Society of Jesus
WK	Week
CTFA	Cosmetic, Toiletry, and Fragrance Association
14AA41	One for all, and all for one
PRESH	Precious
AFLM	Advocates for Life Ministries
GG	Gotta Go
CETA	Comprehensive Employment and Training Act
AF	April Fools
DGAF	Don't give a *freak*
WILPF	Women's International League for Peace and Freedom
G9	Genius
ICC	International Chamber of Commerce
IWAWO	I want a way out
IUB	Intrauterine occlusion body
SYS	See you soon 
ASEAN	Association of Southeast Asian Nations
AYV	Are you vertical?
EEC	Euthanasia Educational Council
GOMER	Get out of my emergency room
MS	Master of Science
GRNC	Gay Rights National Lobby
WDYT	What do you think?
@TEOTD	At the end of the day
IRD	Institute for Resource Development, Westinghouse
SWL	Screaming with laughter
XYL	Ex-young lady, meaning wife. (amateur radio) 
NGLTF	National Gay and Lesbian Task Force
P2P	Peer to peer
GFN	Gone for now
SD	Sweet dreams
PSI	Population Services International
NC	Nordic Council
T+	Think positive
NGHEF	National Gay Health Education Foundation, Inc.
QOTD	Quote of the day
IMO	In my opinion
XLR8	faster or going faster
IRS	Internal Revenue Service
BCOY	Big crush on you
BT	Bite this
Q4U	(I have a) question for you
CFD	Concern for Dying
TIPPS	Technical Information Population for the Private Sector
W/	With
G2G	Got to go
CSC	Civil Service Commission
NARAL	National Abortion Rights Action League [formerly the National 
CISS	Chromosomal in-situ suppression hybridization
55555	Crying your eyes out (Mandarin Chinese txt msgs)
RTFM	Read the *freaking* manual
YL	Young lady
ZOG	Zionist Occupation Government
FAF	Funny as *freak*
RFC	Religious Formation Conference
BF	Best friend
XYZ	Examine your zipper
BOT	Be on that
SCUM	Society for Cutting Up Men
ICRC	International Committee of the Red Cross
TOJ	Tears of joy
CCR	Citizens for Congressional Reform
S'OK	It' (s) okay (ok)
F	Fart
1CE	Once
HL	House of Lords
LI	LinkedIn
CPM	Cesarian Prevention Movement
WEBA	Women Exploited By Abortion
IF	Intellectual Freedom
IRTLF	International Right to Life Federation
R8	Rate (SMS)
j00r	Your
STB	Sacrae theologiae baccalaureus
VC	Voice chat
GTC	Gay Teachers Coalition
XD	a devilish smile
CCR	Center for Constitutional Rights
CMAP	Cover my *a* partner
OPEC	Organization of Petroleum Exporting Countries
ACNM	American College of Nurse-Midwives
WC	Who cares
APA	American Psychological Association
BC	Be cool
4COL	For crying out loud
ROFLMAO	Rolling on the floor, laughing my *butt* off
ES	Erase screen
W8	Wait
IC	I see
CT	Certified teacher
AFSCME	American Federation of State, County, and Municipal Employees
APSH	Association for Persons with Severe Handicaps
IYQ	I like you
EE2	Ethinyl estradiol
SDS	Students for a Democratic Society
PPAF	Planned Parenthood Action Fund
CNN	Cable News Network
AOE	Area of effect (online game)
CSC	Congregatio Sanctae Crucis
UCLA	University of California at Los Angeles
ESA	European Space Agency
JACGUAR	Johns and Call Girls United Against Repression
SAA	Sexual Addicts Anonymous
GF	Girl friend
OC	Oral contraceptive
LULZ	joke, or for laughs
SIFT	Sperm Intrafallopian Transfer
OIC	Organization of the Islamic Conference
MM	Sister (Mandarin Chinese txt msg)
ASF	American Suicide Foundation
WLF	Washington Legal Foundation
ZPG	Zero Population Growth
IGF	Insulin-like growth factor
BB	Be back
LMS	Like my status (Facebook)
TPM	Tomorrow p.m.
GPA	Grade-point average
FBM	Fine by me
BWMT	Black and White Men Together
RTMS	Read the manual, stupid
MPS	Mucopolysaccharidoses
FEITCTAJ	*Freak* 'em if they can't take a joke
IGP	I got to (go) pee
GBTW	Get back to work
ACOP	American College of Osteopathic Pediatricians
BA	Bachelor of Arts
RTLC	Right to Life Crusade
LOLWTF	Laughing out loud (saying) What the *freak*?
P.C.	Politically correct
AHA	American Humane Association
831	I love you (8 letters, 3 words, 1 meaning)
U-L	You will
APA	American Psychiatric Association
CERES	Center for Research in Education and Sexuality
TYSO	Thank you so much
COS	Because
UNDIESA	United Nations Department of International Economic and Social Affairs 
CR	Calendar rhythm
HIRE	Hooking is Respectable Employment
CMIIW	Correct me if I'm wrong
NGU	Non-gonococcal urethritis
FYI	For your information
YWHNB	Yes, we have no bananas
GL/HF	Good luck, have fun 
IIIO	Intel inside, idiot outside
CMA	Canadian Medical Association
GNE1	Good night everyone
WBS	Write back soon
AT&T	Atlantic Telephone and Telegraph
HOAS	Hold on a second
FWYW	Fart when you want
UT2L	You take too long
UDEAC	Union Douaniere et Economique de l'Afrique Centrale
USCL	United States Coalition for Life
EWTN	Eternal Word Television Network
IMNSHO	In my not so humble opinion
UF	You farted
W/END	Weekend
AfDB	African Development Bank
TBT	Throwback Thursday (Twitter slang)
SG	Surgeon General
FEMALE	Formerly Employed Mothers at Loose Ends
POAHF	Put on a happy face
GB	Goodbye
AMA	American Medical Association
AIGHT	Alright
OCSO	Order of Cistercians of the Strict Observance
DGYF	Dang, girl you fine
CDRR	Committee for the Defense of Reproductive Rights
DC	Disconnect
DLC	Democratic Leadership Council
QFB	Queers fight back
SIDS	Sudden Infant Death Syndrome
S4L	Spam for life
2MOR	Tomorrow
NS	Nice split
NOWL	knowledge
HSG	Hysterosalpingogram
SB	Should be
CLF	Conservation Law Foundation
411	information
WAREZ	pirated (illegally gained) software
CORE	Congress of Racial Equality
GLA	Good luck all
AANS	American Academy of Neurological Surgeons
YA	Your
BFD	Big freaking deal
JK (J/K)	Just kidding
OM	Oh, my
QSL	Reply 
APEC	Asia Pacific Economic Cooperation
PCUSA	Presbyterian Church of the USA
TBA	To be aborted
BD	Big deal
LMAO	Laughing my *a* off
KFY	Kiss for you
WHO	World Health Organization
URW	You are welcome
IH2F	I have to fart
VGG	Very good game
BYOH	Bat you on (the) head
BION	Believe it or not
CUSA	Cavitron ultrasonic surgical aspirator
LULZ	joke, or for laughs
AIAMU	And I am a money's uncle
CCR	Citizens for Congressional Reform
121	One-to-one (private chat initiation)
EST	[Werner] Erhardt Sensitivity Training Seminars
GUM	Great unwashed masses
AOG	Assembly of God
MBS	Mutual Broadcasting System
DHT	Dihydrotestosterone
IAC	In any case
VBAC	Vaginal birth after Cesarian [section]
HC	Holy Communion
AI	Artificial insemination
NON	National Organization of Non-Parents
NWRA	National Welfare Rights Association
AGP	Association of Gay Psychologists
AFGE	American Federation of Government Employees
MEH	a so-so or just okay
KOW	Knock on wood
X!	a typical woman
MYO	Mind your own (business)
BIF	Before I forget
WP	Warsaw Pact
DM	Doesn't matter
SF	Someone farted
GOMB	Get off my back
SRSLY	Seriously
PMFJI	Pardon me for jumping in
OJ	Only joking
GBTW	Get back to work
GWHTLC	Glad we had this little chat
PLAL	Pro-Life Action Network
SLBM	Submarine-Launched Ballistic Missiles
CRBT 	Crying really big tears 
Downvote	Voting negatively on a thread using Reddits voting system (Reddit)
IF	I farted
^URS	Up yours
ILYSM	I love you so much
ILU	I love you
TSTB	The sooner, the better
DMY	Don't mess yourself
CT	Can't talk
KMT	Kiss my tushie
H.B.	House Bill
QSO	Conversation
WIC	Women, Infants and Children Program
O	hugs
HBD	Happy birthday
R	are
TANKING	owning
OH	Overheard
IFGR	International Foundation for Genetic Research
EE	Engaged Encounter
NACHRI	National Association of Children's Hospitals and Associated Institutions
KFY	Kiss for you
HEW	[United States Department of] Health, Education and Welfare
PS	Postscriptum
JCL	Licentiate in Canon Law
SNCC	Student Non-Violent Coordinating Committee
SYL	See you later 
NFPFA	Natural Family Planning Federation of America
WRI	World Resources Institute
WHCF	White House Conference on Families
MYOB	Mind your own business
TD	Tower defense
UNIFEM	United Nations Development Fund for Women
RW	Renaissance Women
CRAFT	Can't remember a *freaking* thing
NT	Nice try
DD	Doctor of Divinity
SPK	Speak (SMS)
ASL	Age/sex/location
D46?	Down for sex?
SorG	Straight or Gay?
ENTA	Norethindrone acetate
TC	Take care
ICYMI	In case you missed it (Twitter slang)
AUL	Americans United for Life
AACP	American Academy of Child Psychiatry
PLZ	Please
NT	New Testament
DC	Developed country
GTC	Gay Teachers Coalition
AANS	American Academy of Neurological Surgeons
UNRWA	United Nations Relief and Works Agency for Palestine Refugees in the 
GM-CSF	Granulocyte-macrophage colony-stimulating factor
AOM	Age of Mythology
DD	Due diligence
MM	Maryknoll Missioners
PSA	Public service announcement
SOS	help
FSA	Family Service Association
ATL	Association of Trial Lawyers
CUL	Catholics United for Life
CSII	Continuous subcutaneous insulin infusion
WITW	What in the world
FITB	Fill in the blank
TTLY	Totally
NRCA	Natural Resources Council of America
APP	Application
KDFU	Means Cracking (K) the (D as in Da) *freak* up
VoIP	Voice over Internet Protocol (definition)
DILLIGAF	Do I look like I give a *freak*?
CARICOM	Caribbean Community and Common Market
ARC	Archive (compressed files)
NORCL	National Organization for the Repeal of Cocaine Laws
L2G	Like to go?
FC'INGO	For crying out loud
OAPEC	Organization of Arab Petroleum Exporting Countries
HAWT	sexy or attractive
CEP	Council on Economic Priorities
NEP	New Economic Policy
TYS	Told you so
DPS	Damage per second
FAY	*Freak* all you
COR	Coalition on Revival
AMBW	All my best wishes
GNIGHT	Good night
LAAL	Life After [sexual] Assault League
OBV	Obviously
P-IUD	Progestagen-releasing intrauterine devices
CSCE	Conference on Security and Cooperation in Europe
SSA	Social Security Act
BFFL	Best friends for life
WFF	Women for Faith and Family
ALL	American Life League
IF	I farted
DL	Dead link
GTFO	Get the *freak* out
INPLAN	Integrated Population and Development Planning
YMCA	Young Men's Christian Association
NRHP	National Reproductive Health Project
POT	potion
FART	Floor Assistance Rescue Team
1DR	I wonder
ICCR	Interfaith Center on Corporate Responsibility
ACE	marijuana cigarette
AAP	American Academy of Pediatrics
GD/R	Grinning, ducking, and running
GRL	Girl
SAM	Society for Adolescent Medicine
Bloke	Man (Discord)
PCUC	People Concerned for the Unborn Child
TANKING	owning
n00b	Newbie
XOXOXO	Hugs & Kisses
NACHO	North American Conference of Homophile Organizations
SLAP	Sounds like a plan
CDL	Citizens for Decency Through Law
USU	Usually
SYL	See you later 
SUYF	Shut up you fool
NM	Nice meld
GPA	Grade-point average
IMS	I am sorry
TANKED	owned
YSIC	Your sister in Christ
SB	Smiling back
PETA	People for the Ethical Treatment of Animals
WRI	World Resources Institute
OAS	Organization of American States
RW	Real world
APS	Artificial placentation system
GGMSOT	Gotta get me some of that
IAAA	I am an accountant
ASRC	Abortion Survivors Rescue Committee
KOL	Kiss on cheek
MTCR	Missile Technology Control Regime
F	Fart
SPHA	Solid-phase hemadsorption assay
UV	Unpleasant visual
BITMT	But in the meantime
SPUC	Society for the Protection of the Unborn Child
NCDC	National Catholic Development Conference
WTM	Who's the man?
SAC	State Advisory Committee
Y?	Why?
WUW	What u (you) want?
YKW	You know what
JCL	Licentiate in Canon Law
UPI	United Press International
FHA	Future Homemakers of America
BCO	Big crush on
QFE	Question for everyone
UTM	You tell me
IF	I farted
WOMBAT	Waste of money, brains and time
S'OK	It' (s) okay (ok)
NSC	National Security Council
LCD	Lowest common denominator
IYO	In your opinion
ABD	Already been done
INAL	I'm not a lawyer
YRYOCC	You're running your own cuckoo clock
ACS	Americans for Common Sense
YT	YouTube
BFF	Best friends forever
SELA	Sistema Economico Latinoamericana
Xn	Christian
GNE1	Good night everyone
AFDC	Aid for Families with Dependent Children
RMMM	Read my mail man
CPE	Council on Population and Environment
GRATZ	Congratulations
SAT	Scholastic Aptitude Test
ALMA	Adoptee's Liberty Movement Association
RBAY	Right back at you
CAC	Christian Action Council
NCGLC	National Coalition of Gay and Lesbian Counselors
PITA	Pain in the *butt*
RTL	Right to Life
FACS	Fellow of the American College of Surgeons
K	Okay
FOMC	Falling off my chair
G	Grand
WKD	Weekend
IUD	Intra-uterine device
DLBBB	Don't let (the) bed bugs bite
HLA	Hola / hello (Spanish SMS)
AVDP	Avoirdupois
GLNG	Good luck next game
OCD	Order of Discalced Carmelites
CCA	Christian Community Association
^^	read line or read message above
JD	Juris Doctor
FU	*Freak* you
DV	Deo volente
2MI	Too much information
BVM	Blessed Virgin Mother
ACA	Americans for Constitutional Action
BIOYN	Blow it out your nose
L.A.	Latin America
Op	cit Opere citato
2NTE	Tonight
BBC	British Broadcasting Corporation
GCC	Gulf Cooperation Council
CIAO	Good-bye (Italian word)
RFN	Right *freaking* now
HTH	Hope this helps
PRT	Please Retweet (Twitter slang)
81	Hells Angels (H=8th letter of alphabet, A=1st letter of alphabet)
BISFLATM	Boy, I sure feel like a turquoise monkey! (unverified)
TIL	Today I learned
DKDC	Don't know, don't care
AELC	Association of Evangelical Lutheran Churches
EVA	Ever
ATP	Adenosine triphosphate
WPS	World Population Society
HLF	Human Life Foundation
VIP	Very important person
1TG, 2TG	number of items needed for win
FEW	Federally Employed Women
OCarm	Order of Carmelites
X	Kiss
DXNRY	Dictionary
NGL	Not gonna (going to) lie
SOS	help
FPWA	Federation of Protestant Welfare Agencies
Z%	Zoo
VD	Venereal disease
GAP	Gay Awareness Program
WFS	World Fertility Survey
ECAFE	Economic Commission for Asia and the Far East
DSM	Diagnostic and Statistical Manual
ABA	American Bar Association
AA	Ask about
EEG	Electroencephalogram
KJV	King James Version
ARAL	Association to Repeal Abortion Laws
ACK	Acknowledge
Op	cit Opere citato
CRF	Constitutional Rights Foundation
4	Short for for in SMS
RW	Revolutionary Worker Magazine
THNX	Thanks
PVS	Persistent vegetative state
KB	Keyboard
CUA	See you around
WWNC	Will wonders never cease
CRIT 	critical hit
AZT	Azidothymidine
GFI	Go for it
JP	Justice of the Peace
ETO	Estimated time of ovulation
EO	Executive Order
DYNWUTB	Do you know what you are talking about?
PTSD	Post-traumatic stress disorder
OP	On phone
PAF	Platelet-activating factor
AFC	Away from computer
FEITCTAJ	*Freak* 'em if they can't take a joke
VFM	Value for money
QUEST	Queers Undertaking Exquisite and Symbolic Transformation
FART	Floor Assistance Rescue Team
RME	Rolling my eyes
^5	High-five
ACTH	Adrenocorticotropic hormone
UNTSO	United Nations Truce Supervision Organization
10X	Thanks
UTM	You tell me
NO1	No one
POT	potion
GTRM	Going to read mail 
F	[Degrees] Fahrenheit
TMB	Tweet me back (Twitter slang)
GnRHa	Gonadotrophin-releasing hormone agonist
AMEN	AIDS in Multi-Ethnic Neighborhoods Study
FOAD	*Freak* off and die
NASSP	National Association of Secondary School Principals
HSA	Health Systems Agencies
USCSC	United States Civil Service Commission
OT	Off topic (discussion forums)
LFG	Looking for group
GNSD	Good night, sweet dreams
FISH	Fluorescent in-situ hybridization
ABD	Already been done
SAC	State Advisory Committee
GMA	Gay Militant Atheists
GAC	Get a clue
ASA	American Sociological Association
GS	Good split
OHHEMMGEE	Oh My God (alternate of OMG)
LAW	Legal Action for Women
GOP	Grand Old Party
MLM	give the middle finger
PA	Physicians assistant
CALC	Clergy & Laity Concerned
PKU	Phenylketonuria
MIT	Massachusetts Institute of Technology
ASLA	Age/sex/location/availability
WISP	Winning is so pleasurable
YIU	Yes, I understand
YNK	You never know
DERP	stupid or silly
BB/BSA	Big Brothers/Big Sisters of America
BRB	Be right back
AIM	Accuracy in Media
WRUD	What are you doing?
CPS	Contraceptive Prevalence Surveys
MEH	a shrug or shrugging shoulders
JCAH	Joint Commission on the Accreditation of Hospitals
SOT	Short of time
VFM	Value for money
EOS	End of show
PVP	Player versus player
IVF-DE	IVF-donor embryo
81	Hells Angels (H=8th letter of alphabet, A=1st letter of alphabet)
iiFAR	Incurably Ill for Animal Research
YHL	You have lost
HAWT	sexy or attractive
CCCB	Canadian Conference of Catholic Bishops
TANK	really strong
AC	Acceptable content
AAMFT	American Association for Marriage and Family Therapy
88	Bye-bye (Mandarin Chinese txt msgs) 
FTBOMH	From the bottom of my heart
FEHB	Federal Employee's Health Benefits
NO1	No one
MOD	Modification
MIRL	Meet in real life
WC	Welcome
GANK	a player ambush or unfair player kill
EPC	Environmental Policy Center
FCA	Fellowship of Christian Athletes
WFTU	World Federation of Trade Unions
MUSM	Miss you so much
BCOY	Big crush on you
*w*	wink 
DYJHIW	Don't you just hate it when...?
459	Means I love you (ILY is 459 using keypad numbers)
LNMP	Last normal menstrual period
L8R	Later
FBB	Facebook buddy
MTF	More to follow
GOI	Get over it
SK8RBOI	Skater Boy
PU	That stinks!
RUOK	Are you okay?
RGR	Roger (I agree, I understand)
CPC	Crisis Pregnancy Center
LOA	List of acronyms
ROFLCOPTER	Rolling on floor laughing and spinning around
PBOOK	Phonebook (e-mail)
DES	Diethylstilbestrol
HGP	Human Genome Project
ESAD	Eat *S* and die!
^URS	Up yours
RS	Runescape
DACOWITS	Defense Advisory Committee on Women in the Services
GHOST	Grand Homosexual Organization to Stop Televangelists
PIC	Picture
10M	Ten man
W/B	Welcome back
ASAP	As soon as possible
GIAR	Give it a rest
SOS	help
ADIH	Another day in hell
DOE	Daughter of Eve
CULA	See you later alligator
IFRP	International Fertility Research Program
CSS	Counter-Strike Source
ZACE	Zoapatle aqueous crude extract
GATT	General Agreement on Tariffs and Trade
ALD	Adrenoleukodystrophy
D/L	Download
ISLY	I still love you
OGC	Office of General Council
ENTA	Norethindrone acetate
SPARTECA	South Pacific Regional Trade and Economic Cooperation Agreement
RCA	Reformed Church of America
MACS	Multicenter AIDS Cohort Study
CSCE	Conference on Security and Cooperation in Europe
E	Enemy
FOAD	*Freak* off and die
CAC	Christian Action Council
DG	Dei Gratia
511	Too much information (more than 411)
GR8	Great
CEEAC	Communaute Economique des Etats de l'Afrique Centrale
WWJD	What would Jesus do?
WITP	What is the point?
2MORO	Tomorrow
MOMBOY	Mamma's boy
OH	Overheard
MOOS	Member of the opposite sex
UTI	Urinary tract infection
TBH	To be honest
UNCTAD	United Nations Conference on Trade and Development
NCC	National Council of Churches
WEU	Western European Union
PIP	Peeing in pants (laughing hard)
PP/WP	Planned Parenthood/World Population
JBS	John Birch Society
CARICOM	Caribbean Community and Common Market
EST	Eastern standard time
NIEO	New International Economic Order
HLF	Human Life Foundation
NTS	Note to self
OT	Occupational therapy
MEH	a shrug or shrugging shoulders
IVF-DE	IVF-donor embryo
YBIC	Your brother in Christ
GAU	Gay Academic Union
WUF	Where are you from?
DAR	Daughters of the American Revolution
ATEOTD	At the end of the day
LIK	liquor
DDC	Dewey Decimal Classification
ARP	Association for Retarded Persons
WARN	Women of All Red Nations
ARHP	Association of Reproductive Health Professionals
UCC	United Church of Christ
KK	Knock, knock
RMLB	Read my lips baby
IAAL	I am a lawyer
NVR	Never
PCO	Polycystic ovary syndrome
YIU	Yes, I understand
ZOMG	Used in World of Warcraft to mean OMG (Oh My God)
SO	Significant other
BB	Bebi / Baby (Spanish SMS)
55555	Crying your eyes out (Mandarin Chinese txt msgs)
IA8	I already ate
ARAC	Animal Rights Activists for Choice
LHO	Laughing head off
CICRED	Committee for International Cooperation in National Research in 
IYKWIM	If you know what I mean
NCDC	National Catholic Development Conference
BFFL	Best friends for life
SUYF	Shut up you fool
LOL	Lots of love
PRW	People/parents are watching
NTL	National Teens for Life
EMILY	Early Money is Like Yeast
HV	Humanae Vitae
WIPO	World Intellectual Property Organization
JTLYK	Just to let you know
2N8	Tonight
OL	Old lady
HAND	Have a nice day
CAEU	Council of Arab Economic Unity
PM	Private Message
TMWFI	Take my word for it
GnRH	Gonadotrophin-releasing hormone
MCAD	Medium-chain acyl-CoA dehydrogenase deficiency
ADDY	Address
OMFG	Oh my *freaking* God
PTIYPASI	Put that in your pipe and smoke it
GIRL	Guy in real life
WITCH	Witches' International Conspiracy from Hell
GATT	General Agreement on Tariffs and Trade
R	[Degrees] Rankin
YCHT	You can have them
APL	Adopted People for Life
TD2M	Talk dirty to me
PU	That stinks!
UPU	Universal Postal Union
PPL	People
DSI	Development Services International of Canada
AAUN	American Association of the United Nations
LLGB	Love, later, God bless
BRH	Be right here
MWAH	kiss (it is is the sound made when kissing through the air)
G/F	Girlfriend
CHILD	Christians Helping in Life's Defense
EWI	Emailing while intoxicated
UNOSOM	United Nations Operation in Somalia
WCF	Women's Campaign Fund
NUL	National Urban League
NMH	Not much here
CAN	Cult Awareness Network
FWHC	Feminist Women's Health Center
F	Fart
4AO	For adults only
FAY	*Freak* all you
TMYL	Tell me your location
ACHR	American Convention on Human Rights
2MI	Too much information
GL2U	Good luck to you
JDI	Just do it
CWYL	Chat with you later
RTRCTV	Retroactive (email, Government)
FWYW	Fart when you want
ROFLMAO	Rolling on the floor, laughing my *butt* off
NIC	Newly industrializing country
1DR	I wonder
SYS	See you soon 
143	I love you
ILUM	I love you man
WE	Whatever
AUL	Americans United for Life
AOYP	Angel on your pillow
TVC	Traditional Values Coalition
PCC	Population Crisis [or Control] Committee
WDYT	What do you think?
AMWA	American Medical Women's Association
CUDESH	Council for Democratic and Secular Humanism
PA	Public address
FCF	Free Congress Foundation
YYSSW	Yeah, yeah, sure, sure, whatever
OM	Ovulation method
GLF	Gay Liberation Front
IHM	[Servants of the] Immaculate Heart of Mary
YSYD	Yeah sure you do
NBFO	National Black Feminists Organization
TP	Treponema pallidum
UFB	Un *freaking* believable
P	Partner
DTR	Define the relationship
NAPARE	National Association for Perinatal Addiction, Research, and Education
TAUMUALU	Thinking about you miss you always love you
PTIYPASI	Put that in your pipe and smoke it
DIY	Do it yourself
IG	Instagram
CYA	See you
D&C	Dilatation and curettage
IC	I see
B2C	Business-to-consumer
MIT	Massachusetts Institute of Technology
CBSS	Council of the Baltic Sea States
BIP	Basic infertile pattern
DR	Didn't read
LDO	Like, duh obviously
CAP	Committee for American Principles
AEA	Adoption Exchange Program
KSC	Kind (of) sort (of) chuckle
RM	Reichsmark
AGI	Alan Guttmacher Institute
SB	Senate Bill
OFM	Order of Friars Minor
KTF	Keep the Faith
*s*	smile  
AYOR	At your own risk
RHLA	Respect Human Life Act
HAWT	sexy or attractive
NYA	National Youth Administration
4EVA	Forever
OJ	Only joking
PTL	Praise the Lord
JP	Just playing 
POIDH	Picture, or it didn't happen
CMIIW	Correct me if I'm wrong
AGA	American Gay Atheists
UNOS	United Network for Organ Sharing
AHA	American Hospital Association
86	Over
CCEL	Christian Civic Education League
NE1	Anyone
MX	Missile, experimental
IFFLP	International Federation for Family Life Promotion
EDT	Eastern daylight time
FRT	For real though
CSSP	Center for Studies of Suicide Prevention
INTRAH	[Program for] International Training in Health, University of North 
OMB	Office of Management and Budget
OTB	Off to bed
WENCH	Women with Enough Nerve to Create Havoc
FACOG	Fellow, American College of Obstetrics and Gynecology
PI	Pearl Index
YKWYCD	You know what you can do
HF	Have fun
SRSLY	Seriously
ME	Marriage Encounter
MGMT	Management
NOWL	knowledge
WL	Whatta loser
Z	Z's are calling (meaning going to bed/sleep)
MEHH	a sigh or sighing
CWYL	Chat with you later
IAAD	I am a doctor
BAM	Below average mentality
AML	All my love
WCA	Who cares anyway
YR	Your
DHS	Demographic and Health Surveys
WTG	Way to go
AYT	Are you there?
HAGO	Have a good one
7K	Sick
EOD	End of discussion
CHAUS	Catholic Health Association of the United States
GS	Good split
DBAU	Doing business as usual
INV	Invite
YTTL	You take too long
WEP	Weapon
GDABM	Global Defense Against Ballistic Missiles
MEH	a so-so or just okay
511	Too much information (more than 411)
INFACT	Infant Formula Coalition
AFAIAA	As far as I am aware
W@	What?
UGTBK	You've got to be kidding
YTB	Youth talk back
NGHEF	National Gay Health Education Foundation, Inc.
GAS	Greetings and salutations
LOTR	Lord of The Rings
CYA	See you
SWAG	free stuff and giveaways from tech tradeshows (definition)
G9	Genius
SIMYC	Sorry I missed your call
CAHEA	Committee on Allied Health Education and Accreditation
BYOC	Bring your own computer
CR8	Create
UR2YS4ME	You are too wise for me
ICCR	Interfaith Center on Corporate Responsibility
TYAFY	Thank you and *freak* you
ELCA	Evangelical Lutheran Church in America
NAPWA	National Association of People with AIDS
F	Fart
ASC	American Security Council
NEH	National Endowment for the Humanities
ASHA	American Social Health Association
BAE	Babe or baby
SSDD	Same stuff, different day
SWALK	Sealed (or sealed) with a loving kiss
CPE	Council on Population and Environment
RUT	Are u (you) there?
LNG	Levonorgestrel
YF	Wife
VA	Veterans Administration
AGA	Alliance of Gay Artists
ROTFL	Rolling on the floor laughing
SPCA	Society for the Prevention of Cruelty to Animals
HAGO	Have a good one
CYO	Catholic Youth Organization
AFJ	April Fool's joke
SLAP	Sounds like a plan
BAO	Be aware of
RME	Rolling my eyes
MMK	okay? (as a question)
KOC	Kiss on cheek
GLE	Good luck everyone
TT	Trending topic (Twitter slang)
TOT	Tubal ovum transfer
WDYK	What do you know?
WOC	Women's Ordination Conference
KK	Okay, Okay!
UNIKOM	United Nations Iraq-Kuwait Observation Mission
DD	Doctor of Divinity
QFT	Quoted for truth
SorG	Straight or Gay?
NM	Never mind
CRE8	Create
ITAM	It's The Accounting, Man (financial blogs)
NOWL	knowledge
WUT	what
YT	YouTube
WRT	With regard to
VWP	Very well played
AUSCS	Americans United for Separation of Church and State
G2TU	Got to tell u (you)
NM	Never mind
NRL-PAC	National Right to Life Political Action Committee
AAK	Alive and kicking
ED	Erase display
ALOL	Actually laughing out loud
HOW	Happiness of Womanhood
BTA	But then again
IFFS	International Federation of Fertility Societies
AFA	American Family Association
UN	United Nations
K	of P Knights of Pythias
BACAOR	Bay Area Coalition Against Operation Rescue
AML	All my love
HHS	[United States Department of] Health and Human Services
AFDC	Aid for Families with Dependent Children
AATK	Always at the keyboard
POV	Privately owned vehicle (originally used to differentiate an individual's vehicle from a military vehicle)
FA	Fundamentalists Anonymous
CPF	Committee to Protect the Family
?	I have a question
GOL	Giggling out loud
CW	Conventional wisdom
CUA	See you around
CPUSA	Communist Party of the United States of America
TBC	To be continued
POC	Products of conception'
WB	Welcome back
UF	You farted
4NR	Foreigner 
MFW	My face when... (Used with photo or gif)
Feelsbatman	A social meme taking feelsbadman to the extreme. This references the DC super hero Batmanbecause he witnessed the murder of his parents.
ONL	Online
WTH	What the heck?
B/G	Background (personal information request)
OCC	Order of Calced Carmelites
UHGTBSM	You have got to be s#$t*ing me!
SELFIE	A photo that is taken of oneself for social media sharing (definition)
DAoC	Dark Age of Camelot
CSL	Can't stop laughing
ADIH	Another day in hell
ALEC	American Legislative Exchange Council
Q	Queue
GT	Good try
FTA-Abs	Fluorescent treponemal antibody-absorption
ERP	Erotic Role-Play
SYL	Spartacus Youth League
TRO	Temporary restraining order
FWYW	Fart when you want
WUT	what
EOL	End of lecture
JJA	Just joking around
APA	American Psychoanalytic Association
OIB	Oh, I'm back
NAM	Nonaligned Movement
NERF	Changed and is now weaker
BYOP	Bring your own paint (paintball)
DN	Down
FAS	Federation of American Scientists
UCLA	University of California at Los Angeles
AYDY	Are you done yet?
LNMP	Last normal menstrual period
APLIC	Association for Population/Family Planning and Information Centers
EOT	End of transmission
CAHEA	Committee on Allied Health Education and Accreditation
ECG	Electrocardiogram
DFL	Dead *freaking* last
KKK	Ku Klux Klan
OCart	Order of Carthusians
KEWL	Cool
NCFR	National Council on Family Relations
CYO	See you online
LII	Life Issues Institute
DAP	Dial-a-porn
MSH	Management Sciences for Health
GL	Good luck
FZ	Franc Zone
IOMH	In over my head
BOL	Best of luck
IRNFP	International Review of Natural Family Planning
IM	Instant message
LIK	liquor
JSD	Doctor of Juristic Science
PLZTLME	Please tell me
WWYC	Write when you can
KK	Okay, Okay!
TFF	Too *freaking* funny
IHM	[Servants of the] Immaculate Heart of Mary
SC	Stay cool
DAM	Don't annoy me
DGAF	Don't give a *freak*
L2P	Learn to play
BUBU	Slang term for the most beautiful of women
ABA	American Bar Association
JCL	Licentiate in Canon Law
URSKTM	You are so kind to me
W3	WWW (Web address)
IPA	International Phonetic Alphabet
PPU	Pending pick-up
CLD	Could
AAP	Always a pleasure
YR	Your
TD	Tower defense
AWC	After awhile crocodile
NAE	National Association of Evangelicals
GLA	Good luck all
CU	See you too
X-1-10	Exciting
GCC	Gulf Cooperation Council
IDGAF	I don't give a *freak*
ALOL	Actually laughing out loud
BFG	Big  freaking grin
GRL	Girl
EMFBI	Excuse me for jumping in
S-T	Sympto-thermal
DTTD	Don't touch that dial
IUD	Intra-uterine device
INRI	Iesus Nazarenus Rex Iudaeorum
CARE	Counseling for Abortion-Related Experiences
GG	Brother (Mandarin Chinese txt msgs)
EMSG	E-mail message
MEHH	a sigh or sighing
MMK	okay? (as a question)
BDAY	Birthday
SOAB	Son of a *B*
FLE	Family Life Education
YWHOL	Yelling woohoo out loud
MFS	Mobilization for Survival
CSS	Counter-Strike Source
KOS	Kid over shoulder
MAIDS	Murine [mouse] Acquired Immune Deficiency Syndrome
DCL	Doctor of Canon Law
HSLDA	Home School Legal Defense Association
G+	Google+
