FAY	*Freak* all you
SPC	South Pacific Commission
NBD	No big deal
BRB	Be right back
CSER	Committee for the Scientific Examination of Religion
CFA	Committee for Future America
VEG	Very evil grin
USCC	United States Catholic Conference
ME	Menstrual extraction
OURS	Organization for United Response
GBS	Gay bowel syndrome
OTW	Off to work
BVM	Blessed Virgin Mother
Z	Z's are calling (meaning going to bed/sleep)
AOH	Ancient Order of Hibernians
FACOG	Fellow, American College of Obstetrics and Gynecology
NFS	National Fertility Study
PRM	Physicians for Moral Responsibility
GS	Good shot
NLSY	National Longitudinal Survey of Youth
IHM	[Servants of the] Immaculate Heart of Mary
STR8	Straight
NATO	North Atlantic Treaty Organization
ACW	Action for World Community
ZOT	Zero tolerance
HIT	Herd of independent thinkers [syndrome]
OMI	Oblates of Mary Immaculate
ZC	Zangger Committee
RSCJ	Religious of the Sacred Heart of Jesus
YIU	Yes, I understand
ELI	Environmental Law Institute
NAS	National Audobon Society
NSG	Nuclear Suppliers Group
AMF	Arab Monetary Fund
MEGO	My eyes glaze over
OT	Occupational therapy
FIIOOH	Forget it, I'm out of here
AIHCA	American Indian Health Care Association
BATF	Bureau of Alcohol, Tobacco and Firearms
CUA	Catholic University of America
LMBO	Laughing my butt off
LNG	Levonorgestrel
ILBL8	I'll be late
BOM	Billings Ovulation Method
VAT	Value added tax
BASOR	Breathing a sigh of relief
CPE	Council on Population and Environment
NHANES	National Health and Nutrition Examination Survey
EIP	Editing in progress
NVM	Never mind
RRC	Reproductive Rights Coalition
CYA	See you
LSHMBH	Laugh so hard my belly hurts
MIRL	Me in real life
USU	Usually
SD	Senile dementia
Feelsbadman	A social meme that means to feel negative.
ACT-UP	AIDS Coalition to Unleash Power
IDGAF	I don't give a *freak*
AAF	As a matter of fact
SDC	Social Development Center
LTS	Laughing to self
NIRS	Nuclear Information Resource Service
GFN	Gone for now
KTF	Keep the Faith
APC	American Parents Committee
CAEU	Council of Arab Economic Unity
CCC	Customs Cooperation Council
NARRAL	National Abortion and Reproductive Rights Action League
ICFILWU	I could fall in love with you
DWM	Divorced white male
ITOP	Induced termination of pregnancy
IDUNNO	I don't know
CSC	Congregatio Sanctae Crucis
HOW	Happiness of Womanhood
CONUS	Continental United States
Q4U	(I have a) question for you
NCAN	National Coalition of American Nuns
DV8	Deviate
NIB	Nordic Investment Bank
FU	*Freak* you
ROTC	Reserve Officers Training Corps
ECOSOC	Economic and Social Council
UNTSO	United Nations Truce Supervision Organization
APPP	Association of Planned Parenthood Physicians
STL	Sacrae theologiae licentiatae
IMO	International Maritime Organization
NSM	National Survey of Men
FITB	Fill in the blank
RCA	Reformed Church of America
ICBM	Intercontinental ballistic missile
TANK	really strong
QALY	Quality adjusted life years
ACE	Alliance for Chastity Education
FEBS	Federation of European Biochemical Societies
CTO	Check this out
IPPF	International Planned Parenthood Federation
IGHT	I got high tonight
ETA	Estimated time of arrival
RMLB	Read my lips baby
CODEL	Coordination in Development
KPC	Keeping parents clueless
ESMP	Enhanced survival of multifetal pregnancy
NLF	National Liberation Front
HL	House of Lords
BSOD	Blue screen of death
TMI	Too much information
IAO	I am out (of here)
P	Partner
PSS	Peace Science Society
MCC	Metropolitan Community Church
BPLM	Big person little mind
TUI	Turning you in
BIRTH	Born Individuals Rescuing the Helpless
F	[Degrees] Fahrenheit
OERI	Office of Educational Research and Improvement
VP	Vice President
1UP	extra life
BLNT	Better luck next time
CLS	Critical Legal Studies
LD50	Lethal Dose 50%
CMB	Call me back
GH	Good hand
NCDC	National Catholic Development Conference
AORN	American Association of Registered Nurses
AFJ	Alliance for Justice
TTFN	Ta ta for now
BOT	Be on that
NACHRI	National Association of Children's Hospitals and Associated Institutions
LSMT	Life-sustaining medical treatment
SS	Saints
NCOG	National Council of Obstetrics and Gynecology
UX	User experience
ARAL	Association to Repeal Abortion Laws
WTB	Want to buy
EZY	Easy
SAIDS	Simian
HHIS	Head hanging in shame
EOD	End of discussion
411	information'
NCC	National Catholic Coalition
Msgr	Monsignor
NIMBY	Not in my back yard
SAA	Society for Applied Anthropology
NEA	National Endowment for the Arts
HLC	Human Life Center
AAP	American Academy of Pediatrics
EBKAC	Error between keyboard and chair
COR	Coalition on Revival
IOW	In other words
LERK	Leaving easy reach of keyboard
SAT	Sorry about that
CIA	Central Intelligence Agency
D&C	Dilatation and curettage
MeSH	Medical subject headings
TD	Tower defense
R8	Rate (SMS)
HQ	Headquarters
DYFI	Did you find it?
IGA	International Gay Association
TMOT	Trust me on this
K	Okay
AHA	American Historical Association
GOL	Giggling out loud
HV	Humanae Vitae
AFSCME	American Federation of State, County, and Municipal Employees
Z	Zero
IGN	I (I've) got nothing
NRCA	Natural Resources Council of America
APA	American Psychological Association
PDA	Population Development Association
TBL	Text back later
CETA	Comprehensive Employment and Training Act
AGA	American Genetic Association
EMSG	E-mail message
2N8	Tonight
IMTM	I am the man
SSA	Social Security Administration
FAS	Federation of American Scientists
C4N	Ciao for now
FTW	For the win
OMG	Oh my gosh
CPC	Crisis Pregnancy Center
AOTA	All of the above
YARLY	Ya, really?
DD	Due diligence
CTSA	Catholic Theological Society of America
NRHRC	National Rehabilitation Hospital Research Center
PAF	Platelet-activating factor
CWLA	Child Welfare League of America
IR	International Review
GTSY	Great (or good) to see you 
YWSYLS	You win some, you lose some
BIF	Before I forget
LYLC	Love you like crazy
SMHID	Scratching my head in disbelief
YSYD	Yeah sure you do
YD	Yesterday
BOYF	Boyfriend
NIE	National Institute for Education
PPIH	Population Planning and International Health
CT	Can't talk
MYOB	Mind your own business
CHAP	Child Health Assurance Program
ThD	Doctor of Theology
YNK	You never know
PA	Prothonotary apostolic
NGL	Not gonna (going to) lie
UPC	United Pro-Life Council
AUL	Americans United for Life
CDC	Centers for Disease Control
ALERT	American Life Education and Research Trust
DRG	Diagnosis-related group
PLAL	Pro-Life Action Network
CCAR	Central Conference of American Rabbis
HMG	Human menopausal gonadotrophin
MS	Master of Science
AMA	American Medical Association
CM	Calendar method
OPA	Organ Procurement Agency
TPM	Tomorrow p.m.
EMFBI	Excuse me for jumping in
BA	Bachelor of Arts
RSN	Real soon now
OCC	Order of Calced Carmelites
VITI	Vaginal intratubal insemination
CIDA	Canadian International Development Agency
WARN	Women of All Red Nations
GTRM	Going to read mail 
BAU	Business as usual
?	I don't understand what you mean
STM	Sympto-thermal method
CPS	Current Population Surveys
ONUSAL	United Nations Observer Mission in El Salvador
LTL	Laparoscopic tubal ligation
KEYME	Key me when you get in
AATK	Always at the keyboard
AMFAR	American Foundation for AIDS Research
AVDP	Avoirdupois
ADL	Anti-Defamation League [of B'nai B'rith]
CP	Congregation of the Passion
TFRI	Transnational Family Research Institute
BPOE	Benevolent and Protective Order of Elks
UDS	Ugly domestic scene
TDTM	Talk dirty to me
GM-CSF	Granulocyte-macrophage colony-stimulating factor
IAEA	International Atomic Energy Agency
GCC	Gulf Cooperation Council
AFA	American Family Association
UPU	Universal Postal Union
IB	I'm back
LVM	Left voice mail
WUU2	What are you up to?
NCCC	National Coalition of Clergy and Laity
RIP	Rest in peace
NSC	National Security Council
OIC	Organization of the Islamic Conference
SRA	State's Rights Amendment
NAF	National Abortion Federation
OAPP	Office of Adolescent Pregnancy Programs [United States Department of 
WEEBO	Describes a person obsessed with of Japanese culture
SRD	Society for the Right to Die
KMK	Kiss my keister
JTLYK	Just to let you know
SAMA	Student American Medical Association
IWAWO	I want a way out
JSI	John Snow, Inc.
OJ	Only joking
AA	American Atheists
TSH	Tripping so hard
FBO	Facebook official (An official update from Facebook)
N1	Nice one
RLY	Really
FOLKS	Friends of Little Kids
YHL	You have lost
SOS	Secular Organization for Sobriety Societies
CALM	Custody Action for Lesbian Mothers
ICASC	International Contraception, Abortion, and Sterilization Campaign
NALOPKT	Not a lot of people know that
AF	April Fools
WRUD	What are you doing?
A&A	Amniocentesis and abortion
LIC	Like I care
BTYCL	Bootycall'
SRSLY	Seriously
CCEL	Christian Civic Education League
UNIFEM	United Nations Development Fund for Women
RTBS	Reason to be single
RTMS	Read the manual, stupid
BME	Based on my experience
L.A.	Latin America
SNAFU	Situation normal all fouled up
IVIG	Intravenous immunoglobulin
WAP	Women Against Pornography
YWHOL	Yelling woohoo out loud
2MOR	Tomorrow
TOTES	Totally
ANA	American Nurses Association
L/GHTS	Lesbian and Gay Humanists
UKTR	You know that's right
BUBU	Slang term for the most beautiful of women
PPFA	Planned Parenthood Federation of America
OLL	Online love
NM	Nothing much
AANS	American Academy of Neurological Surgeons
Facepalm	Used to represent the gesture of smacking your forehead with your palm to express embarrassment or frustration
P.R.	Public relations
SBIA	Standing back in amazement
ICU	Intensive care unit
M$	Microsoft
GnRHa	Gonadotrophin-releasing-hormone analogue
NFW	No *freaking* way
ECA	Economic Commission for Africa
VIP	Voter identification project
QED	Quod erat demonstrandum
ACC	Anyone can come
NOAPP	National Organization on Adolescent Pregnancy and Parenting
BSEC	Black Sea Economic Cooperation Zone
SU	Shut up
TM	Trust me
SNAFU	Situation normal
NGHC	National Gay Health Coalition
DILLIGAS	Do I look like I give a sugar?
*s*	smile  
URW	You are welcome
IUSS	If you say so
HF	Have fun
UNFPA	United Nations Fund for Population Activities
AMA	Ask me anything (Reddit)
CB	Coffee break
RYB	Read your Bible 
MINURSO	United Nations Mission for the Referendum in Western Sahara
NTD	Neural tube defect
DCL	Doctor of Canon Law
ProPAC	Progressive Political Action Committee
UAE	United Arab Emirates
X!	a typical woman
GOP	Grand Old Party
PDR	Physicians Desk Reference
RW	Revolutionary Worker Magazine
GnRH	Gonadotrophin-releasing hormone
HDL	High-density lipoprotein
B-DAY	Birthday
NFS	Need for Speed
PLD	Played
AMWA	American Medical Women's Association
WAH	Working at home
MM	Moral Majority
TYT	Take your time
POV	Point of View [television program]
PWA	Person
GAU	Gay Academic Union
XOXOXO	Hugs & Kisses
AIR-PLUS	American Information Route Toward a Pro-Life United States
SJW	Social justice warrior
WOA	Work of Art
NICU	Neonatal intensive care unit
IOM	International Organization for Migration
81	Hells Angels (H=8th letter of alphabet, A=1st letter of alphabet)
GOBs	Good old boys
FAAK	Falling asleep at keyboard
PAU	Pan American Union
TLK2UL8R	Talk to you later
LMIRL	Lets meet in real life
POC	Products of conception'
ABT2	About to'
BOHICA	Bend over here it comes again!
IRD	Institute for Resource Development, Westinghouse
BSTS	Better safe than sorry
NAE	National Association of Evangelicals
PCO	Polycystic ovary syndrome
PC	Population Communication
TMWFI	Take my word for it
SQ	Square
CLC	Campaign Life Coalition
FICCL	Frankly I couldn't care a less
WMA	World Medical Association
TOS	Terms of service
CEO	Chief executive officer
LULZ	joke, or for laughs
4COL	For crying out loud
HP	Hit points / Health points
TOU	Thinking of you
CEPGL	Communaute Economique des Pays des Grands Lacs
TFR	Total fertility rate
ABBR	abbreviation
CAD	Short for Canada/Canadian
CFC	Chlorofluourocarbons
RYS	Are you single?
APHA	American Public Health Association
XYL	Ex-young lady, meaning wife. (amateur radio) 
NCC	National Council of Churches
1432	I love you too
RH	Rhesus [positive or negative]
TTTT	These things take time
IFGR	International Foundation for Genetic Research
AAD	Alliance Against Defamation
NON	National Organization of Non-Parents
LRF	Luteinizing releasing factor
NARW	National Assembly of Religious Women
FYI	For your information
ABEDA	Arab Bank for Economic Development in Africa
T4BU	Thanks for being you
SDMB	Sweet dreams, my baby
PDA	Pregnancy Disability Act
BOHICA	Bend over here it comes again
BAMF	Bad *a* mother *f*
NACC	North Atlantic Cooperation Council
VVF	Vesico-vaginal fistula
WYWH	Wish you were here
OTT	Over the top
PFT	Pretty *freaking* tight
10M	Ten man
SJ	Society of Jesus
NAS	National Association of Scholars
DIIK	Darned if I know
ICEA	International Childbirth Education Association
2B	To be
WAS	Wait a second
NRL-PAC	National Right to Life Political Action Committee
UNRWA	United Nations Relief and Works Agency for Palestine Refugees in the 
PDQ	Pretty damn quick
MSH	Management Sciences for Health
AIR	As I remember
MoD	March of Dimes
OTP	On the phone
CARICOM	Caribbean Community and Common Market
NDA	Natural Death Act
WYLEI	When you least expect it
SFAIK	So far as I know
NICA	National Interfaith Coalition on Aging
CORE	Congress of Racial Equality
ADDY	Address
FRT	For real though
ROFLCOPTER	Rolling on floor laughing and spinning around
LIFE	Life Issues in Formal Education
POPTECH	Population Technical Assistance Project
YTTL	You take too long
SCI-COP	Committee for the Scientific Investigation of Claims of the Paranormal
TY	Thank you
PBS	Public Broadcasting System
WH5	Who, what, when, where, why
CPUSA	Communist Party of the United States of America
WBS	Write back soon
GD	Good
ADIP	Another day in paradise
FRI	Family Research Institute
SAM	Society for Adolescent Medicine
Clear-TV	Christian Leaders for Responsible Television
ECMO	Extracorporeal membrane oxygenation
ISO	International Organization for Standardization
IFN	Interferon
CBTV	Coalition for Better Television
SUITM	See you in the morning
CP	Communist Party
DM	Deutsche Mark
AVC	American Veterans Committee
LEMENO	Let me know
MNSG	Mensaje (message in Spanish)
20	location
DYFM	Dude, you fascinate me
LBVS	Laughing, but very serious
INC	incoming
VOGUE	Valiant Out Gays United in Energy
FA	Fundamentalists Anonymous
BYOC	Bring your own computer
CDI	Center for Defense Information
WUT	what
NMJC	Nothing much, just chilling
AFAIUI	As far as I understand it
SOAB	Son of a *B*
NVR	Never
UER	User effectiveness rate
SSSS	Society for the Scientific Study of Sex
PTIYPASI	Put that in your pipe and smoke it
PRT	Party
LDC	Less-developed country
FUTAB	Feet up, take a break
CISPES	Committee in Solidarity With the People of El Salvador
FIL	Father in law
FBB	Facebook buddy
TBT	Throwback Thursday (Twitter slang)
APO	Army Post Office
PSA	Public service announcement
WHCH	White House Conference on Hunger
KK	Okay, Okay!
TLC	Tender loving care
CMEA	Council for Mutual Economic Assistance
CLRCR	Catholic League for Religious and Civil Rights
AFSC	American Friends Service Committee
FIF	*Freak* I'm funny
UDI	Unidentified drinking injury (meaning bruise, scratch, ache and so on)
O	hugs
INTERPOL	International Criminal Police Organization
EG	Evil grin
CFY	Calling for you
SUP	What's up?
GNA	Good night all
CFC	Combined Federal Campaign
OEO	Office of Economic Opportunity
CREOG	Council on Resident Education in Obstetrics and Gynecology
TRUTH	Teens Rescuing Unborn Tiny Humans
INS	Immigration and Naturalization Service
?	I have a question
APA	American Pharmaceutical Association
PA	Parents Anonymous
ECOSOC	[United Nations] Economic and Social Council
FHI	Family Health International
E1	Everyone
OC	Order of Cistercians
EST	[Werner] Erhardt Sensitivity Training Seminars
MTF	More to follow
CSG	Chuckle, snicker, grin
AML	All my love
BAO	Be aware of
DARE	Drug Abuse Resistance Education
2MORO	Tomorrow
HLI	Human Life International
FCF	Free Congress Foundation
OMAA	Oh, my aching *A* (butt)
PLS	Please
NANN	National Association of Neonatal Nurses
CJR	Citizens for Judicial Restraint
ERS2	Eres tz / are you (Spanish SMS)
OVA	Over
420	Marijuana
BFG	Big  freaking grin
ASLA	Age/sex/location/availability
ADIH	Another day in hell
ROTFLUTS	Rolling on the floor laughing unable to speak
DSM	Diagnostic and Statistical Manual
ATEOTD	At the end of the day
WTO	World Tourism Organization
FCAA	Florence Crittenden Association of America
XLNT	Excellent 
9	Parent is watching 
ASL	Age/sex/location
SB	Should be
AAL	American Abolitionist League
IMNSHO	In my not so humble opinion
AAMOF	As a matter of fact
GLA	Good luck all
CEMA	Council for Mutual Economic Assistance
SH	Same here
Q	Queue
OSU	Order of St. Ursula
COPE	Committee on Political Education
TL;DR	Too long; didn't read
ALD	Adrenoleukodystrophy
GAMDA	Group Against Media Dishonesty on Abortion
AISA	Adoption Information Service Agency
CRB	Come right back
OTOH	On the other hand
NPLD	National Pro-Life Democrats
FACS	Flourescence-activated cell sorter
S&M	Sado-masochism
DNT	Don't
PSHA	Public Service Health Act
FDA	[United States] Food and Drug Administration
CFD	Concern for Dying
WPS	World Population Society
RTFQ	Read the *freaking* question
IVD	Intravas device
NRDA	Natural Resources Defense Association
AEA	Adoption Exchange Program
LHM	Lord help me
DC	Disconnect
PLMK	Please let me know
FOCA	Freedom of Choice Act
OCI	Ovum capture inhibitor
AI	Artificial intelligence
PHWFL	Public Health Workers for Life
IIIO	Intel inside, idiot outside
GR&D	Grinning, running and ducking
DXNRY	Dictionary
IME	Institute of Medical Ethics
O	Opponent
CMA	Catholics for a Moral America
CDB	Caribbean Development Bank
AJC	American Jewish Congress
KSC	Kind (of) sort (of) chuckle
NCA	National Chastity Association
IGF	Insulin-like growth factor
86	Over
GALAS	Great American Lesbian Art Show
oob	off our backs [Magazine]
OCart	Order of Carthusians
AKA	Also known as
YTG	You're the greatest
AGI	Alan Guttmacher Institute
NGHEF	National Gay Health Education Foundation, Inc.
CPG	Catholic Physicians Guild
B	Be
UN4TUN8	Unfortunate
IWSN	I want sex now
AP	Associated Press
AG	Attorney general
CARE	Counseling for Abortion-Related Experiences
NCHA	National Council on Higher Education
SAARC	South Asian Association for Regional Cooperation
OB	Oh brother
CSS	Counter-Strike Source
JFF	Just for fun
VBAC	Vaginal birth after Cesarian [section]
FACES	National Association for the Craniofacially Handicapped
AIAMU	And I am a money's uncle
FAO	Food and Agricultural Organization
GL2U	Good luck to you
PIC	Picture
R	[Degrees] Rankin
VGG	Very good game
IFFS	International Federation of Fertility Societies
AJOG	American Journal of Obstetrics and Gynecology
AEAP	As early as possible
PKMN	Pokemon
IMO	In my opinion
GG	Good Game
NORC	National Opinion Research Center
IUCD	Intra-uterine contraceptive device
LDS	Latter-Day Saints
BCNU	Be seeing you
CYEP	Close your eyes partner
WEP	Weapon
RTLC	Right to Life Crusade
IOOF	International Order of Odd Fellows
WUZ	was
G+	Google+
CARAL	Canadian Abortion Rights Action League
FAB	Fabulous
ASIG	And so it goes
HYFR	Hell yeah, *Freaking* right!
1NAM	One in a million
LLLI	La Leche League International
ACP	American College of Physicians
IUP	Intrauterine pregnancy
MC	Merry Christmas
D.A.	District attorney
FFM	Fund for a Feminist Majority
MUAH	Multiple unsuccessful attempts (at/to) humor
L8RG8R	Later, gator
GF	Girl friend
VGH	Very good hand
IDA	International Development Association
JOICFP	Japanese Organization for International Cooperation in Family Planning, 
EEC	European Economic Community
ARF	Animal Rights Front
TYAFY	Thank you and *freak* you
ADA	Adenosine deaminase
PLZ	Please
SWS	Sociologists for Women in Society
THNQ	Thank-you (SMS)
j00r	Your
VSF	Very sad face
EIB	Excellence in Broadcasting [Network]
OMG	Oh my God
OPM	Office of Personnel Management
VFW	Veterans of Foreign Wars
WMO	World Meteorological Organization
CAC	Christian Action Council
ICM	Intergovernmental Committee for Migration
k/b	Keyboard
ZH	Sleeping Hour
AIH	Artificial insemination
HNL	(w)Hole 'nother level
411	information
ASHG	American Society of Human Genetics
AU	Angstrom unit
PETA	People for the Ethical Treatment of Animals
SQUASH	Super Queers United Against Savage Heterosexuals
STOPP	Stop Planned Parenthood
IFYP	I feel your pain
KROW	Keep Rockefeller out of Washington
NRC	National Research Council
Bloke	Man (Discord)
FWHC	Feminist Women's Health Center
4NR	Foreigner 
CNF	Conservation Network Foundation
ASPEN	American Society for Parenteral and Enteral Nutrition
SIDS	Sudden Infant Death Syndrome
SA	Sexaholics Anonymous
ICOMP	International Council on Management of Population Programmes
ASMA	American Student Medical Association
NM	Never mind
AMEN	AIDS in Multi-Ethnic Neighborhoods Study
ANZUS	Australia-New Zealand-United States Security Treaty
LAPAC	Life Amendment Political Action Committee
JJA	Just joking around
ACK	Acknowledge
AACP	American Academy of Child Psychiatry
CUT	Church Universal and Triumphant
IPS	Institute for Policy Studies
ENUF	Enough
GnRHa	Gonadotrophin-releasing hormone agonist
Downvote	Voting negatively on a thread using Reddits voting system (Reddit)
OP	Optimum Population, Inc.
ATCC	American Type [Cell] Culture Collection
AAUW	American Association of University Women
VN	Very nice
VRY	Very
MUSM	Miss you so much
DFA	Development Fund for Africa
A/S/L	Age/sex/location
UW	You're welcome
IPA	International Phonetic Alphabet
PRO	Parents' Rights Organization
PP	Planned Parenthood
NUL	National Urban League
PHS	[United States] Public Health Service
AFS	American Fertility Society
WFP	Witness for Peace
FBF	Fat boy food (e.g. pizza, burgers, fries)
AE	Artificial embryonation
TL	Too long
OAPEC	Organization of Arab Petroleum Exporting Countries
ZIFT	Zygote intra-fallopian transfer
WLDF	Women's Legal Defense Fund
CMGR	Community manager
WU	What's up?
JACGUAR	Johns and Call Girls United Against Repression
HOAS	Hold on a second
NPC	National People's Congress
WIC	Women's International Conference
CPB	Corporation for Public Broadcasting
LBS	Laughing, but serious
WHCA	White House Conference on Aging
B/G	Background (personal information request)
UWA	United Way of America
SJD	Doctor of Juridical Science
UNIKOM	United Nations Iraq-Kuwait Observation Mission
PO	Post office
FC	Fingers crossed
YOLO	You only live once
SUYF	Shut up you fool
NORCL	National Organization for the Repeal of Cocaine Laws
AFDC	Aid for Families with Dependent Children
LII	Life Issues Institute
CRLP	Center for Reproductive Law and Policy
GJ	Good job
FEC	Federal Elections Commission
NPFC	National Pro-Family Coalition
NPR	National Public Radio
MU	Miss U (you)
CCL	Conference for 'Catholic' Lesbians
YBIC	Your brother in Christ
UNCRTN	Uncertain
ARM	Abortion Rights Mobilization
ZOG	Zionist Occupation Government
MIT	Massachusetts Institute of Technology
FRCS	Fellow of the Royal College of Surgeons, London
AFP	[Maternal] alpha-feto protein
ESF	Economic support funds
AVES	Australian Voluntary Euthanasia Society
UTM	You tell me
NOPE	National Optimum Population Effort
GSA	Gay Students Association
CUMID	See you in my dreams
EOL	End of lecture
FEITCTAJ	*Freak* 'em if they can't take a joke
DHS	Demographic and Health Surveys
WAM	Wait a minute
ARHO	Association of Reproductive Health Officials
BGCS	Boyhood Gender Conformity Scale
TEGWAR	The exciting game without any rules
RU	Are you?
HAG1	Have a good one
WCL	World Confederation of Labor
NGU	Non-gonococcal urethritis
NE1	Anyone
P-FLAG	Parents and Friends of Lesbians and Gays
SPI	Sisters of Perpetual Indulgence
VoIP	Voice over Internet Protocol (definition)
CAM	Camera (SMS)
ALADI	Asociacion Latinoamericana de Integracion;
HB	Hurry back
MPS	Mucopolysaccharidoses
FCOL	For crying out loud
SEAL	Sea, Air, Land
ATSL	Along the same line (or lines)
WRT	With regard to
55555	Crying your eyes out (Mandarin Chinese txt msgs)
BOAD	Banque Ouest-Africaine de Developpement
EE2	Ethinyl estradiol
UN	United Nations
Y	Yawn
IUB	Intrauterine occlusion body
AE	American Education Association
ED	Erase display
MRW	My reaction when... (Used with photo or gif)
B4N	Bye for now
NCGO	National Coalition of Gay Organizations
SWAT	Scientific wild *butt* guess
XD	really hard laugh (where D is a smiley mouth)
KISS	Keep it simple, stupid
FAM	Fertility awareness method
ARC	American Red Cross
AFESD	Arab Fund for Economic and Social Development
POV	Privately owned vehicle (originally used to differentiate an individual's vehicle from a military vehicle)
UNAVEM	United Nations Angola Verification Mission
GDABM	Global Defense Against Ballistic Missiles
WITCH	Witches' International Conspiracy from Hell
XYZ	Examine your zipper
EWTN	Eternal Word Television Network
ILS	International Life Services
LD	Long distance
START	Strategic arms reduction treaty
W/E	Whatever
NBFAB	No bad for a beginner
ENTA	Norethindrone acetate
NCJW	National Council of Jewish Women
EKG	Electrocardiogram
PACE	Post-Abortion Counseling and Education
FML	*Freak* My Life
DHU	Dinosaur hugs (used to show support)
NSFG	National Survey of Family Growth
CIAO	Good-bye (Italian word)
n00b	Newbie
RW	Real world
SPTO	Spoke to
RFN	Right *freaking* now
PLO	Palestinian Liberation Organization
DARE	Dykes Against Racism Everywhere
GPA	Grade-point average
DR	Didn't read
TOY	Thinking of you
SADC	Southern African Development Community
BIH	Burn in hell
NSISR	Not sure if spelled right
UPS	Uterine progesterone system
TBA	To be aborted
ACNM	American College of Nurse-Midwives
H-BDAY	Happy Birthday
RHLA	Respect Human Life Act
UNDOF	United Nations Disengagement Observer Force
NCFA	National Committee for Adoption
RTNTN	Retention (email, Government)
ARE	Acronym rich environment
CHOICE	Concern for Health Options, Information, Care and Education
HLA	Human Life Amendment
WB	Welcome back
DYOR	Do your own research (common stock market chat slang)
OOTD	One of these days
LQTM	Laughing quietly to myself
TYFC	Thank you for charity
DEEZ NUTZ	A phrase used in online chat to annoy or frustrate those involved in the conversation.
DD	Dear (or Darling) daughter
NASSP	National Association of Secondary School Principals
BCOY	Big crush on you
CTW	Children's Television Network
NCNW	National Council of Negro Women
NN	Nicaraguan Network
VSC	Very soft chuckle
GAC	Get a clue
UNICEF	United Nations Children's Emergency Fund
GLAD	Gay and Lesbian Awareness Da
ERIS	Exoatmospheric Reentry Intercept System
FAQ	Frequently asked questions
CYO	See you online
PROGGY	computer program
PUSH	People United to Save Humanity
GEA	Gay Educators Association
TSD	Tay-Sachs Disease
PDW	People's Daily World Magazine
WHATEVES	Whatever
WAT	What
BIS	Bank for International Settlements
ABTA	Good-bye (signoff)
OL	Old lady
CM-BBT	Cervical Mucus-Basal Body Temperature
NOPARH	National Office of Post-Abortion Reconciliation and Healing
MEHH	a sigh or sighing
CPA	Certified public accountant
ATM	At the moment
UNTAC	United Nations Transitional Authority in Cambodia
FUBAR	Fouled up beyond all recognition
HIV	Human immunodeficiency virus
RD	Rural delivery
TOJ	Tears of joy
DYJHIW	Don't you just hate it when...?
IVF-DS	IVF-donor sperm
POSSLQ	Person of the opposite sex sharing living quarters
NSCE	National Center for Science Education
AAR	American Academy of Religion
ICAM	I couldn't agree more
CYE	Check your e-mail
IAETF	International Anti-Euthanasia Task Force
JIC	Just in case
TG	Thank goodness
GPO	[United States] Government Printing Office
GIC	Gift in crib
CCR	Center for Constitutional Rights
YF	Wife
CACM	Central American Common Market
BB	Bebi / Baby (Spanish SMS)
NIFOC	Naked in front of computer
MR.(number)	child and his age. Mr.3 would be a 3-year old son
NAM	New American Movement
CRS 	Can't remember *stuff*
GTFO	Get the *freak* out
CHA	Catholic Health Association
AYV	Are you vertical?
TBA	To be announced
ROC	Republic of China
RATS	Radical [AIDS] Activist Truth Squad
HSG	Hysterosalpingogram
SWAT	Special Weapons and Tactics
BEG	Big evil grin
TIAD	Tomorrow is another day
ADAD	Another day, another dollar
AO	Anarchy Online
BSA	Boy Scouts of America
PAPP-A	Pregnancy-associated plasma protein-A
CUA	See you around
DMNO	Dude Man No Offense
AHA	American Humane Association
OMGYG2BK	Oh my God, you got to be kidding
VNH	Very nice hand
HSLDA	Home School Legal Defense Association
WPC	World Population Council
OGIM	Oh God, it's Monday
AAA	Americans Against Abortion
W8	Wait
IFA	International Fertility Association
AOE	Area of effect (online game)
ASAT	Anti-satellite weapons
ARC	AIDS-Related Complex
ALL	American Life League
WE	Whatever
HC	House of Commons
UT2L	You take too long
FINRRAGE	Feminist International Network of Resistance to Reproductive and Genetic
AFDC	American Family Defense Coalition
CBSS	Council of the Baltic Sea States
OOH	Out of here
NCCJ	National Conference of Christians and Jews
NFL	National Football League
SIFT	Sperm Intrafallopian Transfer
NICM	National Institute for Campus Ministries
HMO	Health maintenance organization
AGI	agility
AFK	Away from keyboard
BIP	Basic infertile pattern
NCPAC	National Conservative Political Action Committee
ImL	(in Arial font) Means I love you (a way of using the American sign language in text)
HTLV	Human T-Cell Lymphotropic Virus
IWW	Industrial Workers of the World
IVF-SET	IVF-surrogate embryo transfer
S'OK	It' (s) okay (ok)
SB	Smiling back
NSGC	National Society of Genetic Counselors
UAW	United Auto, Aircraft, and Agricultural Implements Workers of America
GRL	Girl
PAC	Population Action Council
WYCM	Will you call me?
UNIFIL	United Nations Interim Force in Lebanon
OSB	Order of St. Benedict
KB	Keyboard
LCL	League of Catholic Laymen
DORIS	Defending Our Rights in the Streets
L8R	Later
BOOMS	Bored out of my skull
TIL	Today I learned
SS	So sorry
IA8	I already ate
IVF-DE	IVF-donor embryo
AFC	Apostolate for Family Consecration
YTB	You're the best
EPA	Environmental Protection Agency
FOMCL	Falling off my chair laughing
PVP	Player versus player
LSC	Legal Services Corporation
TC	Transcervical
OG	Original gangster
SSDD	Same stuff, different day
4AO	For adults only
DUR	Do you remember?
WIBNI	Wouldn't it be nice if
IAAL	I am a lawyer
AISB	As I said before
PMFJI	Pardon me for jumping in
UTI	Urinary tract infection
CO	Conscientious objector
CHAUS	Catholic Health Association of the United States
EAK	Eating at keyboard
CCPA	Catholics for Christian Political Action
FSA	Family Service Association
YMMV	Your mileage may vary
R	are
G-77	Group of 77
FAA	Federal Aviation Administration
BAS	Big 'butt' smile
SPR	Society for Psychical Research
RTFM	Read the *freaking* manual
AYDY	Are you done yet?
AC	Acceptable content
DM	Do me
LMFAO	Laughing my freaking *a* off
QC	Quality control
AAHS	Americans Against Human Suffering
YHBT	You have been trolled
WTH	What the heck?
BRD	Bored
NCEA	National Catholic Education Association
PTO	Paid time off
NCWUS	National Council of Women of the United States
PSR	Physicians for Social Responsibility
RG	Rio Group
UFL	University Faculty for Life
NCHLA	National Committee for a Human Life Amendment
PCA	Presbyterian Church in America
INFACT	Infant Formula Coalition
CWU	Church Women United
PUG	Pick up group
WRK	Work
SYL	See you later 
WYSIWYG	What you see is what you get 
CFS	Care for secret?
ATP	Adenosine triphosphate
SOP	Standard operating procedure
MTCR	Missile Technology Control Regime
OO	Over and out
UOK	(Are) You ok?
CM	Congregation for the Mission
AMAP	As much as possible
GS	Good split
NYPLC	National Youth Pro-Life Coalition
WFF	Women for Faith and Family
MHD	Magnetohydrodynamics
VD	Venereal disease
DBEYR	Don't believe everything you read
AZN	Asian
JCAH	Joint Commission on the Accreditation of Hospitals
PG	Prostaglandin
RTSM	Read the stupid manual
HZA	Hemizona assay
SPUC	Society for the Protection of the Unborn Child
TAM	Tomorro a.m.
UDDA	Uniform Determination of Death Act
DILLIGAF	Do I look like I give a *freak*?
CCBA	Coalition of Concerned Black Americans
AISI	As I see it
IBRC	Infant Bioethical Review Committee
JAM	Just a minute
ROFLMAO	Rolling on the floor, laughing my *butt* off
DG	Dei Gratia
WUW	What u (you) want?
WADB	West African Development Bank
H-MDAY	Happy Mother's Day
FZ	Franc Zone
NCCC	National Council of Catholic Charities
BWMT	Black and White Men Together
UV	Unpleasant visual
FF	Follow Friday (Twitter slang)
U-L	You will
LABIA	Lesbians and Bisexuals in Action
SV	Soror Vitae
ACA	Americans for a Constitutional Amendment
LOTR	Lord of The Rings
PMFI	Pardon me for interrupting
AAMOI	As a matter of interest
ANM	Auxiliary nurse-midwife
BC	Be cool
INSERM	Institut National de la Sant:e et de la Recherche Medicale
OEEC	Organization for European Economic Cooperation
B2B	Business-to-business
CUF	Catholics United for the Faith
IMPACT	Innovative Materials for Population Action
ACOOG	American College of Osteopathic Obstetricians and Gynecologists
CAP	Children Awaiting Parents
BHL8	Be home late
GORK	God only really knows
YSIC	Your sister in Christ
LLB	Bachelor of Law
QSL	Reply 
CHSA	Consumer Health Service of America
AID	Artificial insemination
AWESO	Awesome
G9	Genius
MISS.(number)	child and her age. Miss.3 would be a 3-year old daughter
OAU	Organization of African Unity
H8TTU	Hate to be you
STFU	Shut the *freak* up
DAM	Don't annoy me
WFS	World Fertility Survey
C	Commonwealth
CRE8	Create
SRP	Short rib-polydactyly syndrome
MAIDS	Murine [mouse] Acquired Immune Deficiency Syndrome
WC	Welcome
NAOP	National Association for Optional Parenthood
H	Hug
EMILY	Early Money is Like Yeast
LYSM	Love you so much
INAL	I'm not a lawyer
KIA	Know it all
IGAB	Interagency Group for Action on Breastfeeding
W/END	Weekend
HRU	How are you?
UUA	Unitarian Universalist Association
FPA	Family planning associates
RT	Retweet (Twitter slang)
GOMB	Get off my back
FSA	Free Speech Advocates
FWM	Fine with me
OP	On phone
COMECON	Coordinating Committee on Export Controls
HCS	Human chorionic somatomammotropin
WHCCY	White House Conference on Children and Youth
QFI	Quoted for irony
LIMT	Laugh in my tummy
DHEW	Department of Health, Education, and Welfare
IRLF	International Right to Life Foundation
GRID	Gay-Related Immune Deficiency
UPI	United Press International
WYD	What (are) you doing?
OP	Order of Preachers
NACAC	North American Council on Adoptable Children
AAF	As a friend
CEP	Council on Economic Priorities
WAN2	Want to? (SMS)
AAUN	American Association of the United Nations
MS	Multiple sclerosis
C&G	Chuckle & grin
SYY	Shut your yapper
CID	Crying in disgrace
SIGMA	Sisters in Gay Ministry Associated
BBIAS	Be back in a sec
SS	Schutzstaffel
PAC	Political action committee
APWU	American Postal Workers Union
CDL	Citizens for Decency Through Law
SPK	Speak (SMS)
NFL	National Federation for Life
SRY	Sorry
MP	Member of Parliament
FOE	Friends of the Earth
FTA-Abs	Fluorescent treponemal antibody-absorption
SYS	See you soon 
KFY	Kiss for you
W3	WWW (Web address)
MB	Megabyte
C-Span	Congressional Coverage Cable Network
NH	Nice hand
ASHA	American Social Health Association
UPUSA	United Presbyterians USA
KKK	Ku Klux Klan
IMHO	In my humble opinion
BION	Believe it or not
RFD	Rural free delivery
SC	Sisters of Charity
NEJM	New England Journal of Medicine
JLMK	Just let me know
MX	Missile, experimental
FCC	Federal Council of Churches
JD	Juris Doctor
BIB	Boss is back
E123	Easy as one, two, three
GTFOH	Get the *freak* outta here
OTL	Out to lunch
NCCL	National Committee of Catholic Laymen
B	Back
QQ	Quick question
RUMOF	Are you male or female?
CN-M	Certified nurse-midwife
NSF	National Science Foundation
POIDH	Picture, or it didn't happen
UT	Unreal Tournament
LDO	Like, duh obviously
UNESCO	United Nations Educational, Scientific, and Cultural Organization
DEIS	Draft environmental impact statement
B2C	Business-to-consumer
MM	Sister (Mandarin Chinese txt msg)
DINK	Double-income, no kids
JC (J/C)	Just checking
LFD	Left for day
SFRY	Socialist Federal Republic of Yugoslavia
TANKING	owning
NAGAP	National Association of Gay Alcoholism Professionals
VIP	Voluntary interruption of pregnancy
2M2H	Too much to handle
NOWL	knowledge
FPIA	Family Planning International Assistance Program
SNCC	Student Non-Violent Coordinating Committee
BM&Y	Between me and you
YBS	You'll be sorry
COYOTE	Cast Off Your Old Tired Ethics
G	Grin
LTOT	Low tube ovum transfer
SPCA	Society for the Prevention of Cruelty to Animals
BIOYN	Blow it out your nose
OOTO	Out of the office
GBTW	Get back to work
CTFA	Cosmetic, Toiletry, and Fragrance Association
ALI	American Liberties Institute
NLFO	National Lesbian Feminist Organization
ICJ	International Court of Justice
SC	Stay cool
PZA	Pizza
GGP	Got to go pee
HLF	Human Life Foundation
FUD	Face up deal
IAAD	I am a doctor
UCS	Union of Concerned Scientists
HIRE	Hooking is Respectable Employment
ZPG	Zero Population Growth
LH	Luteinizing hormone
QIK	Quick
NOOB	someone who is bad at (online) games
H.B.	House Bill
EMA	E-mail address (Twitter slang)
CERES	Center for Research in Education and Sexuality
FCI	Family Care International, Inc.
TCB	Take care of business
CUSA	Cavitron ultrasonic surgical aspirator
IYC	International Year of the Child
SOMY	Sick of me yet?
HM	His or Her Majesty
SUL	See you later
OAS	Organization of American States
CAMPUS	Coalition of American Pro-Life University Students
IYQ	I like you
USSR	Union of Soviet Socialist Republics
OCA	Orthodox Church of America
MHOTY	My hat (is) off to you
CWOT	Complete waste of time
UNDP	United Nations Development Program
CARE	Co-operative for American Remittances to Everywhere
FBOW	For better or worse
AOYP	Angel on your pillow
AISB	As it should be
NAM	Nonaligned Movement
MEH	a so-so or just okay
InCAR	International Committee Against Racism
WFTU	World Federation of Trade Unions
GEEP	Gonadotropin-releasing hormone agonist and exogenous estradiol and
AMBW	All my best wishes
4EVA	Forever
TTAPS	Toon, Turco, Ackerman, Pollack, and Sagan
IWHC	International Women's Health Coalition
NRDC	National Resource Defense Council
SIS	sister
WITW	What in the world
et	seqEt sequens
AASK	Aid to Adoption of Special Kids
PCC	Population Crisis [or Control] Committee
ASLM	American Society of Law and Medicine
NIROK	Not in reach of keyboard
GI	Government issue
GDR	Grinning, ducking, and running
TP	Treponema pallidum
YT	YouTube
LWOS	Laughing without smiling
B2W	Back to work
R&D	Research and development
ACTH	Adrenocorticotropic hormone
GA	Go ahead
MEP	Multiple exposure photography
PA	Public address
STD	Sacrae theologiae doctor
OATUS	On a totally unrelated subject
RGR	Roger (I agree, I understand)
MOM	Mothers Organized for Morality
NCGLC	National Coalition of Gay and Lesbian Counselors
SMP	Social Marketing Project
HHS	[United States Department of] Health and Human Services
DIS	Did I say?
LOLH	Laughing out loud hysterically
KEYA	I will key you later
ESA	European Space Agency
IOMH	In over my head
ROFL	Rolling on floor laughing
AED	Academy for Educational Development
FISH	First in, still here
SAL	Such a laugh
BAY	Back at ya
VWD	Very well done
NIAAA	National Institute of Alcohol Abuse and Alcoholism
GMA	Gay Militant Atheists
DoD	Department of Defense
SBT	Sorry 'bout that
DSP	Daughters of St. Paul
MOO	My own opinion
ELISA	Enzyme-linked immunosorbent assay
APP	Application
ICJ	International Court of Justice
KUTGW	Keep up the good work
BN	Bad news
ILUM	I love you man
BWL	Bursting with laughter 
NAAO	National Association of Artist's Organizations
BR	Best regards
FUAA	Fathers United Against Abortion
BOT	Back on topic
CDA	Catholic Daughters of America
SOS	help
OC	Oral contraceptive
UNIDO	United Nations International Development Organization
OTTOMH	Off the top of my head
FFA	Free for all
404	I don't know
F	female
B4	Before
WTT	Want to trade?
DBAU	Doing business as usual
CPFH	Center for Population and Family Health, Columbia University
GRINCH	Gay Retaliation for Inexcusable Negligence and Criminal Homophobia
IBRD	International Bank for Reconstruction and Development
HD	Huntington's disease
ME	Medical examiner
EIB	European Investment Bank
JW	Just wondering
CAP	Committee for American Principles
LMK	Let me know
BBIAB	Be back in a bit
CSOW	Commission on the Status of Women
KDFU	Means Cracking (K) the (D as in Da) *freak* up
GGE1	Good game, everyone
MPA	Master of Public Administration
JPSA	Joint Program for the Study of Abortion
JAC	Just a second
SD	#VALUE!
CEEAC	Communaute Economique des Etats de l'Afrique Centrale
CLW	Council for a Livable World
PS	Postscriptum
TPTB	The powers that be
LMAO	Laughing my *a* off
Y?	Why?
LOLWTF	Laughing out loud (saying) What the *freak*?
IRL	In real life
CRZ 	Crazy
DIKU	Do I know you?
TWSS	That's what she said
ILO0	International Labor Organization
FLE	Family Life Education
GLE	Good luck everyone
URA*	You are a star
ET	Embryo transfer
NAPSAC	National Association of Parents and Professionals for Safe Alternatives in 
APCW	Adolescent Pregnancy Childwatch Project
FCC	Federal Communications Commission
NP	No problem
DERP	stupid or silly
ASA	Association for the Study of Abortion
NMR	Nuclear magnetic resonance [spectroscopy]
WETSU	We eat this sh_t up
AE	Area effect
AANFP	American Academy of Natural Family Planning
APSH	Association for Persons with Severe Handicaps
PATH	Post-Abortion Trauma Healing
TBH	To be honest
IAE	In any event
URC	University Research Corporation
MAP	More Agricultural Production, Inc.
DFL	Dead *freaking* last
NIDA	National Institute on Drug Abuse
d00d	Dude
MSW	Master of Social Work
DV	Deo volente
LOOM	Loyal Order of Moose
CU2	See you
LD	Later, dude
SCLC	Southern Christian Leadership Conference
TYS	Told you so
ADN	Any day now
DIY	Do it yourself
BIOYA	Blow it out your *a*
WL	Whatta loser
HB	Hug back
NWSC	National Women's Studies Conference
IRC	Interchange Resource Network
ARHP	Association of Reproductive Health Professionals
PIP	Population Information Program, Johns Hopkins University
SDI	Strategic Defense Initiative
GG	Brother (Mandarin Chinese txt msgs)
MACS	Multicenter AIDS Cohort Study
AYW	As you want / As you wish
ALS	Amyotrophic lateral sclerosis
OB	Oh baby
SUX	Meanings sucks or it sucks
PLAN	Protect Life in All Nations
FB	Facebook
ACQSTN	Acquisition (e-mail, Government)
LHO	Laughing head off
QQ (qq) (Q_Q)	crying eyes
FPWA	Federation of Protestant Welfare Agencies
SOUL	Save Our Unwanted Life
WYGAM	When you get a minute
IRCAR	International Reference Center for Abortion Research
TOT	Tubal ovum transfer
NAACP	National Association for the Advancement of Colored People
PS	Pro-Lifers for Survival
NEET	Nafarelin European Endometriosis Trial Group
DWF	Divorced white female
AYEC	At your earliest convenience
ALI	American Law Institute
RFC	Religious Formation Conference
EADB	East African Development Bank
CE	[International Society of] Christian Endeavor
RM	Reichsmark
QFE	Question for everyone
CIS	Center for Inter-American Security
CBC	Congressional Black Caucus
WTS	Want to sell?
AGS	American Gynecological Society
PPD	Purified protein derivative
CGD	Chronic granulomatous disease
AsDB	Asian Development Bank
OR	Operation Rescue
BITMT	But in the meantime
OECD	Organization for Economic Cooperation and Development
NHI	National Health Insurance
SAA	Sexual Addicts Anonymous
FISH	Fluorescent in-situ hybridization
CLAB	Crying like a baby
TSNF	That's so not fair
STB	Sacrae theologiae baccalaureus
PAPOC	Parents Alliance to Protect Our Children
YL	Young lady
BCO	Big crush on
NRN	No response/reply necessary
HUYA	Head up your *butt*
GAS	Gay Alliance of Students
AHEA	American Home Economics Association
SSINF	So stupid it's not funny
7K	Sick
JT (J/T)	Just teasing
AVA	American Victims of Abortion
ASAP	As soon as possible
e.g.	Exempli gratia
WWI	Worldwatch Institute
SK8R	Skater
APAC	All praise and credit
SOR	Shield of Roses
RUT	Are u (you) there?
HVH	Heroic Violet Hold
ABT	About
ILYSM	I love you so much
GCC	Gay Community Center
DSS	Delayed Shock Syndrome
TC	Take care
LOTI	Laughing on the inside
S2R	Send to receive (meaning send me your picture to get mine)
EOS	End of show
PCS	Population Communication Services, Johns Hopkins University
WUF	Where are you from?
PCUSA	Presbyterian Church of the USA
CPF	Committee to Protect the Family
NCCW	National Council of Catholic Women
IFC	International Finance Corporation
EE	Engaged Encounter
RICO	Racketeering-Influenced Corrupt Organizations Act
FEW	Federally Employed Women
K8T	Katie
CLC	Clergy and Laity Concerned
OH	Overheard
WC	Who cares
TNSTAAFL	There's no such thing as a free lunch
PSI	Population Services International
IVF-DO	IVF-donor ova
BBS	Be back soon
DGT	Don't go there
CR8	Create
ASCAP	American Society of Composers, Authors and Publishers
OSM	Order of the Servants of Mary
OM	Ovulation method
FBF	Flashback Friday
FIMH	Forever in my heart
CLF	Conservation Law Foundation
BFAW	Best friend at work
BAD	Banque Africaine de Developpement [African Development Bank 
FFS	For *freak'*sakes
HLS	Human Life Statute
JLIC	Jewish Life Issues Committee
SELA	Sistema Economico Latinoamericana
AAAS	American Association for the Advancement of Science
FLS	Front Line States
GALA	Gay and Lesbian Alliance
JDL	Jewish Defense League
CFR	Code of Federal Regulations
NIEO	New International Economic Order
HFAC	Holy flipping animal crackers
NRHP	National Reproductive Health Project
831	I love you (8 letters, 3 words, 1 meaning)
BOLO	Be on the look out
CCCB	Canadian Conference of Catholic Bishops
WIC	Women, Infants and Children Program
NFP	Natural family planning
ALC	American Lutheran Church
BC	Because
YA	Your
EEC	Euthanasia Educational Council
ITU	International Telecommunication Union
NIC	Newly industrializing country
HAK	Hug and kiss
KOTL	Kiss on the lips
ICAM-1	Intercellular adhesion molecule-1
CALC	Clergy & Laity Concerned
NFS	Not for sale
P2P	Parent to parent
NFWS	Not for work safe
EMBAR	Embarassing
AVS	Association for Voluntary Sterilization
CPM	Cesarian Prevention Movement
EPS	Early Pregnancy Services
AOC	Available on cell
GNP	Gross national product
F2F	Face to face
CEP	Council on Environmental Quality
IMSB	I am so bored
AWOL	Absent without leave
NWCL	National Women's Coalition for Life
BIDS	Birth Defects Information System
BOL	Best of luck
NSFL	Not safe for life
WLNC	Women's Leadership Network Conference
QSO	Conversation
AYSOS	Are you stupid or something?
<3	sideways heart (love, friendship)
BISFLATM	Boy, I sure feel like a turquoise monkey! (unverified)
PPFC	Planned Parenthood Federation of Canada
ARAC	Animal Rights Activists for Choice
SSA	Social Security Act
DMY	Don't mess yourself
HHH	Hyperornithinaemia, Hyperammonaemia, and Homocitrullinuria Syndrome
VC	Voice chat
TARAL	Texas Abortion Rights Action League
X	Kiss
AEC	Atomic Energy Commission
DF	Don't even go there
NAPWA	National Association of People with AIDS
EEG	Electroencephalogram
OTGH	Old-Time Gospel Hour
ICCR	Interfaith Center on Corporate Responsibility
IRMC	I rest my case
EVO	Evolution
WOW	World of Warcraft
POS	Parent over shoulder
ICFTU	International Confederation of Free Trade Unions
AMOF	As a matter of fact
RX	drugs or prescriptions
RHIP	Rank has its privileges
LNMP	Last normal menstrual period
AARP	American Association of Retired Persons
CIV	Cultures, ideas and values [course]
SJR	Senate Joint Resolution
NS	Nice score
PC	Player character
AT	At your terminal
FY	Fiscal year
EI	Eosinophilic index
FBI	Federal Bureau of Investigation
SM	Society of Mary
ACPT	Accept (e-mail, Government)
YTB	Youth talk back
MP	Mana points
VBS	Very big smile
DLC	Democratic Leadership Council
APHA	American Protestant Hospital Association
SPHA	Solid-phase hemadsorption assay
NWPC	National Women's Political Caucus
MWAH	kiss (it is is the sound made when kissing through the air)
BSCS	Biological Sciences Curriculum Study
H&K	Hugs & kisses
CRF	Constitutional Rights Foundation
AYW	As you were
MRT	Modified ReTweet  (Twitter slang)
CURE	Citizens United for Responsible Education
NAPN	National Association of Pro-Life Nurses
T:)T	Think happy thoughts
SWAK	Sent (or sealed) with a kiss
<33	heart or love (more 3s is a bigger heart)
PDH	Pretty darn happy
NAM	"New age" movement
GTW	Multiglycosides of Tripterygium wilfordii
GGOH	Gotta Get Outa Here
CCREF	Conservative Caucus Research and Education Fund
CP	Colombo Plan
AWOL	Away without leaving
DL	Dead link
DEGT	Dear (or Darling) daughter
BRNC	Be right back, nature calls
GSA	General Services Administration
MOD	Moderator
ZOMG	Used in World of Warcraft to mean OMG (Oh My God)
AYT	Are you there?
TVC	Traditional Values Coalition
CSCPA	Committee for Social Change and Political Action
4	Short for for in SMS
NSFW	Not safe for work
DSOC	Democratic Socialist Organizing Committee
KS	Kaposi's Sarcoma
ADD	Address
JW	Jehovah's Witness
TMA	Take my advice
GGU2	Good game, you too
RBAY	Right back at you
MERCOSUR	Mercado Comun del Cono Sur
MNC	Mother nature calls
LAAL	Life After [sexual] Assault League
GOI	Get over it
PTFO	Pass the *freak* out
TFTF	Thanks for the follow (Twitter slang)
LEAD	League for Economic Assistance and Development
STP	Standard temperature and pressure
AANP	American Academy of Nurse Practitioners
TAU	Thinking about u (you)
GATT	General Agreement on Tariffs and Trade
FOMC	Falling off my chair
FSH	Follicle-stimulating hormone
HAGO	Have a good one
HCG	Human chorionic gonadotrophin
GIGO	Garbage in, garbage out
ICCC	International Concerns Committee for Children
CMON	Come on
TALL	Teen American Life League
CERN	Conseil Europeen pour la Recherche Nucleaire
SPST	Same place, same time
ASAP	As soon as possible
KISS	Keep it simple, stupid
WFC	World Food Council
WOMB	Women Opposed to Massacre and Brutality
DTS	Don't think so
MIC	Maternal and Infant Care
ABM	Anti-ballistic missile
GMC	General Medical Council
RTHX	Thanks for the RT (Retweet) (Twitter slang)
WWJD	What would Jesus do?
H2CUS	Hope to see you soon
IIE	Institute of International Education
NFPFA	Natural Family Planning Federation of America
MPH	Master of Public Health
TTET	Transvaginal-transmyometrial embryo transfer
WRAP	White Ribbon Campaign Against Pornography
SIG	Special Interest Group
V	Very
BAG	Busting a gut
GFWC	General Federation of Women's Clubs
LHSX	Lets have sex
NT	New Testament
IHS	Indian Health Service
CULT	Catholics United Against Liberation Theology
EEOC	Equal Employment Opportunity Commission
ORLY	Oh really?
KMT	Kiss my tushie
IDB	Islamic Development Bank
PLEA	Pro-Life Educational Association
YGTBKM	You've got to be kidding me
511	Too much information (more than 411)
BOE	bind on equip
SOS	Son of Sam
BBC	British Broadcasting Corporation
BIC	Butt in chair
QFT	Quoted for truth
PZ	Peace 
PRL	Prolactin
DC	Doctor of Chiropractic
BBA	Balanced Budget Amendment
AAYF	As always, your friend
YT	You there?
BFFLNMW	Best friends for life, no matter what
ADBB	All done, bye-bye
Y2K	You're too kind
CHAMPVA	Civilian Health and Medical Program of the Veterans Administration
BAM	Below average mentality
R2N2	Reproductive Rights National Network
G2G	Got to go
SA	Spontaneous abortion
G	Giggle
BFFL	Best friends for life
DOE	Daughter of Eve
HOPING	Helping in Normal Grieving
SIG2R	Sorry, I got to run
IGADD	Inter-Governmental Authority on Drought and Development
CSE	Classroom sex education system
AFL-CIO	American Federation of Labor and Congress of Industrial Organizations
CUL	See you later
PISS	Put in some sugar
ES	Erase screen
PPP	Planned Parenthood Physicians
ROK	Republic of Korea
CIOMS	Council for International Organizations of Medical Sciences
NTHING	Nothing (SMS)
WAN2TLK	Want to talk
GAFC	Get a *freaking* clue
DC	District of Columbia
BS	Bachelor of Science
ABOG	American Board of Obstetrics and Gynecology
BCOS	Because
CHK	Check
USMC	United States Marine Corps
AF	As *Freak*
DSI	Development Services International of Canada
ACE	marijuana cigarette
FACP	Fellow of the American College of Physicians
AIGHT	Alright
IISHR	International Institution for the Study of Human Reproduction
WICCA	Women in Constant Creative Action
DTR	Define the relationship
CU	See you too
ARL	Americans for Religious Liberty
GGA	Good game, all
PSI	Population Services Institute
MOMBOY	Mamma's boy
PCM	Please call me
NTS	Note to self
CRBT 	Crying really big tears 
POM	Public opinion message
AYOR	At your own risk
EMFBI	Excuse me for butting in
NBFO	National Black Feminists Organization
IWIAM	Idiot wrapped in a moron
ICD	Intracervical device
ECWA	Economic Commission for Western Asia
WWYC	Write when you can
BFD	Big freaking deal
UNDIESA	United Nations Department of International Economic and Social Affairs 
MCCL	Minnesota Citizens Concerned for Life
NAAF	National Association for Abortion Facilities
OT	Old Testament
ELI5	Explain like I'm 5
ILY	I love you
MLM	give the middle finger
IUSSP	International Union for the Scientific Study of Population
TAFN	That's all for now
ADR	Address
VBL	Visible bra line
JV	Joint venture
DL	Download
FUBAR	Fouled up beyond all recognition
HBD	Happy birthday
MCHR	Medical Committee for Human Rights
NRLC	National Right to Life Committee
NORML	National Organization for the Repeal of Marijuana Laws
RNC	Republican National Committee
WISP	Winning is so pleasurable
INTRAH	[Program for] International Training in Health, University of North 
VWP	Very well played
NMH	Not much here
IYSS	If you say so
COB	Close of business
RS	Runescape
JAMA	Journal of the American Medical Association
L2G	Like to go?
RYS	Read your screen 
GB	Goodbye
A/N	Author's note
I2	I too (me too)
CAPD	Continuous ambulatory peritoneal dialysis
UR	You are / You're
MYOB	Mind your own business
WTM	Who's the man?
QOTD	Quote of the day
PAS	Post-abortion syndrome
DACOWITS	Defense Advisory Committee on Women in the Services
BRH	Be right here
GTG	Got to go
USAID	United States Agency for International Development
NCI	National Cancer Institute
PA	Power of attorney
UHGTBSM	You have got to be s#$t*ing me!
IDTS	I don't think so
MA	Master of Arts
LMMFAO	Laughing my mother freaking a** off
ONL	Online
POV	Point of view
EYC	Excitable, yet calm
NC	Nice crib
GRATZ	Congratulations
AIDS	Acquired Immune Deficiency Syndrome
PCI	Pax Christi International
VFM	Value for money
WTG	Way to go
ADMIN	Administrator
L2P	Learn to play
EF4T	Effort
WGACA	What do you think?
ICS	Institute for Creation Spirituality
AA	Alcoholics Anonymous
ASRC	Abortion Survivors Rescue Committee
WASP	We are Satan's people
NWF	National Wildlife Federation
P.C.	Politically correct
NHLA	National Hispanic Lawyers Association
CULA	See you later alligator
ACCT	Agence de Cooperation Culturelle et Technique
ACDNT	Accident (e-mail, Government)
CLD	Could
PRB	Population Reference Bureau
NIH	National Institute of Health
CRASH	Committee Against Racism, Sexism, and Heterosexism
CSsR	Congregatio Sanctissimi Redemptoris
DTRT	Do the right thing
IK	I know
CP	Chat post (or continue in IM)
JAS	Just a second
BFFN	Best friend for now
IBM	International Business Machine
CHEER	Center for Homosexual Education, Evaluation and Research
SK8RBOI	Skater Boy
MGB	May God bless
CID	Criminal Investigation Department
FUBB	Fouled up beyond belief
NE	Any
FTL	For the loss
GI	Girls Incorporated
YR	Yeah right
Buff	changed and is now stronger
RN	Registered nurse
USSR/EE	USSR/Eastern Europe
AfDB	African Development Bank
JP	Just playing 
USPS	United States Postal Service
PI	Private investigator
B/F	Boyfriend
DH	Dear (or Darling) husband
IIED	International Institute for Environment and Development
NIMBY	Not in my back yard
S2S	Sorry to say
ALOL	Actually laughing out loud
EPK&C	Early prenatal karyotype farenand cell scan
AAMFT	American Association for Marriage and Family Therapy
FAF	Funny as *freak*
CTHU	Cracking the *heck* up
459	Means I love you (ILY is 459 using keypad numbers)
LOA	List of acronyms
GP	General practitioner
FBM	Fine by me
SLAA	Sex and Love Addicts Anonymous
VOC	Victims of Choice
THNX	Thanks
G2TU	Got to tell u (you)
CYAL8R	See you later
MDIAC	My Dad is a cop
FWIW	For what it's worth
IYKWIM	If you know what I mean
AIAA	Americans for International Aid and Adoption
NAZI	Nationalen Socialisten
NCSW	National Conference on Social Welfare
AAK	Alive and kicking
KOS	Kid over shoulder
UNEP	United Nations Environment Program
LSV	Language, sex and violence
LOL	Laugh out loud
MSSVD	Medical Society for the Study of Venereal Diseases
UNCTAD	United Nations Conference on Trade and Development
CUL8R	See you later
NM	Nice meld
GLE1	Good luck everyone
UDEAC	Union Douaniere et Economique de l'Afrique Centrale
PROBS	Probably
OTFL	On the floor laughing
MB	Mamma's boy
AGA	Alliance of Gay Artists
CUL	Catholics United for Life
LCD	Lowest common denominator
AFL	Adolescent Family Life
HRT	Hormone replacement therapy
PLAN	Plan Loving Adoption Now
XD	a devilish smile
CWRR	'Catholic' Women for Reproductive Rights
NYA	National Youth Administration
0.02	My (or your) two cents worth
CSSP	Center for Studies of Suicide Prevention
COH	City of Heroes
NEA	Nuclear Energy Agency
OPEN	Organization to Promote Equality Now
URTM	You are the man
ARV	AIDS-related virus
MFS	Mobilization for Survival
BDAY	Birthday
POC	Prisoners of conscience
TTUL	Talk to you later
CCL	Couple to Couple League
COS	Because
YCHT	You can have them
CDRR	Committee for the Defense of Reproductive Rights
MICU	Medical intensive care unit
TEF	The Environmental Fund
GMBA	Giggling my butt off
WATS	Wide Area Telephone System
NCCB	National Council of Catholic Bishops
TM	Transcendental meditation
WNDC	Women's National Democratic Club
AOG	Assembly of God
BTA	But then again
GN	Good night
OS	Operating system
FSP	Fallopian tube sperm perfusion
WWJD	What Would Judd Do? (Artist Donald Judd, who was known to do things in his own compulsive way.)
NOEL	National Organization of Episcopalians for Life
GAS	Got a second?
STM	Sacrae theologiae masterieus
SLAP	Sounds like a plan
CONRAD	Contraceptive Research and Development Program, Eastern Virginia 
MBS	Mutual Broadcasting System
KS	Kill then steal
MIRL	Meet in real life
GNSD	Good night, sweet dreams
GUM	Great unwashed masses
ZUP	What's up?
6Y	Sexy
SPF	South Pacific Forum
BCS	Bethany Christian Services
GDR	German Democratic Republic
AIM	American Indian Movement
NIE	Newly industrializing economy
RL	Real life
RAPID	Resources for the Awareness of Population Impacts on Development
WRA	Women of reproductive age
EOD	End of day
BTDT	Been there, done that
SICNR	Sorry, I could not resist
WOC	Women's Ordination Conference
OMGYS	Oh my gosh you suck 
AID	[United States] Agency for International Development
TURNT	Turn up
LTD	Living the dream
LY	Love ya 
FYEO	For your eyes only
AZT	Azidothymidine
BBQ	Barbeque, Ownage, shooting score/frag
GIAR	Give it a rest
PPPPPPP	Proper prior planning prevents putrid poor performance
KT	Katie
TIET	Transvaginal intratubal embryo transfer
UR2YS4ME	You are too wise for me
EDF	Environmental Defense Fund
KOS	Kill on sight
<3	broken heart
IFCA	International Federation of Catholic Alumnae
ASM	American Society of Mammologists
CICRED	Committee for International Cooperation in National Research in 
CASE	Christian Advocates Serving Evangelism
AFAIC	As far as I am concerned
BRT	Be right there
ISLY	I still love you
SWALK	Sealed (or sealed) with a loving kiss
BFN	Bye for now
L2G	(would) Love to go
SETE	Smiling Ear-to-Ear
CCR	Citizens for Congressional Reform
IFAD	International Fund for Agricultural Development
SLAPP	Strategic lawsuit against public participation
PKU	Phenylketonuria
ASF	American Suicide Foundation
TIA	Thanks in advance
WENCH	Women with Enough Nerve to Create Havoc
IIRC	If I remember correctly
DUPE	Duplicate
Ph.D.	Philosophiae doctor
BBT	Be back tomorrow
SG	Surgeon General
ITEST	Institute for Theological Encounter With Science and Technology
FWB	Friend with benefits
TILIS	Tell it like it is
19	Zero hand
CISS	Chromosomal in-situ suppression hybridization
ABMS	American Board of Medical Specialties
CBS	Columbia Broadcasting System
MFW	My face when... (Used with photo or gif)
DL	Down low
^URS	Up yours
OSF	Order of St. Francis
MTFBWU	May the force be with you
DYNWUTB	Do you know what you are talking about?
IEA	International Energy Agency
IPAS	International Projects Assistance Services
SIT	Stay in touch
TU	Thank you
DTTD	Don't touch that dial
PAW	Parents are watching
LDL	Low-density lipoprotein
IVF	In-vitro fertilization
PPNG	Penicillinase-producing Neisseria gonorrhea
SMSA	Standard Metropolitan Statistical Area
AFZ	Acronym Free Zone
IUI	Intra-uterine insemination
HSA	Health Systems Agencies
SorG	Straight or Gay?
CEIP	Carnegie Endowment for National Peace
AYBABTU	All your base are belong to us
SBC	School-based clinic
IM	Instant message
CCD	Confraternity of Christian Doctrine
X-1-10	Exciting
1CE	Once
GPOY	Gratuitous picture of yourself
GMV	Got my vote
BF2	Battlefield 2
CIF	Conservation International Foundation
IRBM	Intermediate Range Ballistic Missile
SART	Society for Assisted Reproductive Technologies
RT	Roger that
NT	Nice try
TYSO	Thank you so much
88	Hugs and kisses
IRNFP	International Review of Natural Family Planning
kB	Kilobyte
ILO	International Labor Organization
*w*	wink 
PIH	Pyridoxal isonicotinoyl hydrazone
URSKTM	You are so kind to me
Feelsgoodman	A social meme that means to feel positive.
DHT	Dihydrotestosterone
UNMOGIP	United Nations Military Observer Group in India and Pakistan
NCFR	National Council on Family Relations
JFGI	Just *freaking* Google it
KOL	Kiss on cheek
URH	You are hot (U R Hot)
GLSA	Gay Law Students Association
WCF	Women's Campaign Fund
DOT	Damage over time
EDT	Eastern daylight time
ACF	Americans for Constitutional Freedom
DGTG	Don't go there, girlfriend
NAC	Network Action Committee
HUB	Head up butt
WUCIWUG	What you see is what you get
WBU	What about you?
GALA	Gay Atheists League of America
TA	Thanks a lot
AKA	Also known as
OMS	On my soul (meaning promise)
TFS	Thanks for sharing
PIR	Parents in room
DAR	Daughters of the American Revolution
WCCL	Wisconsin Citizens Concerned for Life
CJ	Chief Justice
AF	Aggression factor
THX	Thanks
PIE	Paedophiliac International Exchange
YCDBWYCID	You can't do business when your computer is down
APL	Adopted People for Life
RME	Rolling my eyes
SIM	Simian Immunodeficiency Virus
PNAP	Prolife Nonviolent Action Project
OAS	Organization of American States
PM	Private Message
OT	Off topic (discussion forums)
OBV	Obviously
FOAF	Friend of a friend
STW	Search the Web
IMF	International Monetary Fund
CHCE	Center for Health Care Ethics
GHOST	Grand Homosexual Organization to Stop Televangelists
ICEM	Intergovernmental Committee for European Migration
ACHR	American Convention on Human Rights
SSIF	So stupid it's funny
FYI	For your information
WAYF	Where are you from?
PDQ	Pretty darn quick
IVH	Intraventricular hemorrhage
JHPIEGO	Johns Hopkins Program for International Education in Gynecology and 
UNPC	Un- (not) politically correct
UCMU	You crack me up
PEP	Promoting Enduring Peace
ACD	ALT / CONTROL / DELETE
BSF	But seriously folks
LC-WS	Lutheran Church-Wisconsin Synod
RCP	Royal College of Physicians
TIPPS	Technical Information Population for the Private Sector
YCL	Young Communist League
SP1	Pregnancy-specific beta 1-glycoprotein
UNA	Use no acronyms
OPEC	Organization of Petroleum Exporting Countries
BIL	Brother in law
TBC	To be continued
W/	With
CPGAF	Committee on Population Growth and the American Family
CNN	Cable News Network
YCLIU	You can look it up
MAD	Mutual assured destruction
NSW	New South Wales
AAS	Abortion Abolition Society
DM	Direct message (Twitter slang)
RVN	Republic of Viet Nam
D&E	Dilatation and evacuation
ECLAC	Economic Commission for Latin America and the Caribbean
NEA	National Education Association
BIBO	Beer in, beer out
OT	Ovum transfer
GIFT	Gamete intra-fallopian transfer
DQMOT	Don't quote me on this
IWO	Institute for World Order
C/P	Cross post
BAE	Before anyone else
FRG	Federal Republic of Germany
ELCA	Evangelical Lutheran Church in America
WIPO	World Intellectual Property Organization
DITYID	Did I tell you I'm distressed?
SWMBO	She who must be obeyed. Meaning wife or partner
CVS	Chorionic Villi Sampling
USCL	United States Coalition for Life
ECOWAS	Economic Community of West African States
WTF	What the *freak* ?
UFWM	You *freaking* with me?
NWA	Niggers With Attitude
FTBOMH	From the bottom of my heart
CHA	Christian Holiness Association
XPOST	Cross-post. A link posted to a subreddit that was already shared on a different subreddit (Reddit)
FACE	Freedom of Access to Clinic Entrances [Act]
SAR	Sexual attitude restructuring
GRWG	Get right with God
TOTS	Tubal ovum transfer of sperm
LORCS	League of Red Cross and Red Crescent Societies
GOMER	Get out of my emergency room
PA	Physicians assistant
OOC	Out of character
P911	Parents coming into room alert
IFRP	International Fertility Research Program
PI	Population Institute
WFAVS	World Federation of Associations for Voluntary Sterilization
EAF	Environmental Action Foundation
ACGME	Accreditation Council for Graduate Medical Education
YWHNB	Yes, we have no bananas
ABD	Already been done
NCGSTDS	National Coalition of Gay Sexually-Transmitted Disease Services
HLB	Human Life Bill
NOLSW	National Organization of Legal Social Workers
INPLAN	Integrated Population and Development Planning
LNT	lost in translation
CRAFT	Can't remember a *freaking* thing
ERC	Ethical Research Committee
WCC	World Council of Churches
IMAP	[International Planned Parenthood Federation] Medical Advisory Board 
BOB	Back off *buddy*
KB	Kick butt
HIV-Ag	Human immunodeficiency virus antigen
VGC	Very good condition
AAR	At any rate
INTELSAT	International Telecommunications Satellite Organization
SCAW	Scientists Center for Animal Welfare
HTH	Hope this helps
MG	Myasthenia Gravis
l33t	Leet, meaning 'elite'
MBA	Master of Business Administration
DLTBBB	Don't let the bed bugs bite
SB	Senate Bill
ETA	Estimated time (of) arrival
UNOS	United Network for Organ Sharing
AI	Amnesty International
WSP	Women Strike for Peace
H-FDAY	Happy Father's Day
TLC	Teen Line Connection
NCADP	National Coalition to Abolish the Death Penalty
NWM	New Ways Ministry
SHID	Slapping head in disgust
ETO	Estimated time of ovulation
TNT	Til next time
OSV	Our Sunday Visitor [Magazine]
EBRD	European Bank for Reconstruction and Development
SK8	Skate
GAS	Greetings and salutations
WFP	World Food Program
CED	Committee for Economic Development
PTO	Personal time off
NAJSN	National American Jewish Students Network
ECO	Economic Cooperation Organization
DORBS	Adorable
NMA	National Medical Association
XME	Excuse Me
SMEXI	Combination of sexy and Mexican, used to describe attractive people
SIHTH	Stupidity is hard to take
NACHO	North American Conference of Homophile Organizations
OTA	Office of Technology Assessment
CRIT 	critical hit
SIR	Strike it rich
WAWA	Where are we at?
CB	Chat break
MAR	Mixed antiglobulin reaction
CRA	Center for Reproductive Alternatives
WMA	Women's Medical Association
DDC	Dewey Decimal Classification
WILPF	Women's International League for Peace and Freedom
YRYOCC	You're running your own cuckoo clock
FHA	Federal Housing Administration
CMF	Cardinal Mindszenty Foundation
SAT	Scholastic Aptitude Test
GWHTLC	Glad we had this little chat
CSP	Center for Security Policy
AFLM	Advocates for Life Ministries
LC	Library of Congress
CSC	Civil Service Commission
HUGO	Human Genome Organization
HLSC	Human Life Statute Coalition
NCE	New Catholic Edition
ASEAN	Association of Southeast Asian Nations
IMP	Imprimatur
UCLA	University of California at Los Angeles
ACL	American Collegians for Life
GUD	Good 
ROTFL	Rolling on the floor laughing
D/L	Download
OFM	Order of Friars Minor
EVA	Ever
NFM	Not for me
CHD	Campaign for Human Development
NWLC	National Women's Law Center
BCIE	Banco Centroamericano de Integracion Economico
ALCON	All concerned
MOSS	Member of same sex
ABA	American Bar Association
LFG	Looking for guard
BAE	Babe or baby
AEU	American Ethical Union
EFTA	European Free Trade Association
EST	Eastern standard time
NFD	National Federation for Decency
MOD	Modification
GPHW	Gay Public Health Workers
ARMS	Abortion-Related Ministries
T+	Think positive
APLIC	Association for Population/Family Planning and Information Centers
ICAO	International Civil Aviation Organization
1337	Leet, meaning 'elite'
GFI	Go for it
USGPO	United States Government Printing Office
GAL	Get a life
NFPRHA	National Family Planning and Reproductive Health Association
SOT	Short of time
AYS	Are you serious?
CB	Crazy *b*
BYOP	Bring your own paint (paintball)
AFPOE	A fresh pair of eyes
SOTMG	Short of time, must go
TT	Trending topic (Twitter slang)
FWP	First world problems
YKW	You know what
ESCWA	Economic and Social Commission for Western Asia
TTG	Time to go
AAHA	American Academy of Health Administration
Feelsbatman	A social meme taking feelsbadman to the extreme. This references the DC super hero Batmanbecause he witnessed the murder of his parents.
NTL	National Teens for Life
AAA	American Adoption Agency
NAAPC	National Association for the Advancement of Preborn Children
HRH	His or Her Royal Highness
OMFG	Oh my *freaking* God
B/C	Because
PSYOPS	Psychological operations
PCA	Permanent Court of Arbitration
DPS	Damage per second
WEBO	Webopedia
EZ	Easy
FHA	Future Homemakers of America
BF	Brain fart
LAES	Latin American Economic System
PYT	Pretty young thing
SK8NG	Skating
APS	Artificial placentation system
CBA	Christian Booksellers Association
TANKED	owned
QL	Quit laughing
AHA	American Hospital Association
ISO	In search of
DA	The
ALL	American Life Lobby
K	of C Knights of Columbus
HAWT	sexy or attractive
IEC	Institutional ethics committee
UFB	Un *freaking* believable
APA	American Psychoanalytic Association
NS	Nice split
PROST	Pronuclear stage tubal transfer
UFN	Until further notice
UL	Upload
PPL	Presbyterians Pro-Life
CNS	Committee for National Security
CNP	Continued (in) next post
AIFR	American Institute of Family Relations
B8	Bait (person teased or joked with, or under-aged person/teen)
TTYL	Talk to you later
EQ	EverQuest
WOOMB	World Organization of the Ovulation Method Billings
FC	Full card
SUZI	Sub-zonal insemination
BB/BSA	Big Brothers/Big Sisters of America
OSHA	Occupational Safety and Health Administration
AFAIAA	As far as I am aware
NPC	Non-playing character
SELFIE	A photo that is taken of oneself for social media sharing (definition)
NOYB	None of your business
YCMU	You crack me up
AG	Andean Group
NEW	Network of Empowered Women
GTA	Gay Theatre Alliance
RFRA	Religious Freedom Restoration Act
BCR	Benefit-cost ratio
NCTE	National Council of Teachers of English
STD	Sexually-transmitted disease
DHS	Demographic and Health Surveys
YAF	Young Americans for Freedom
BB	Be back
SOMARC	Social Marketing for Change
SO	Significant other
E	Enemy
AWOL	Absent without leave
OEA	Office of Environmental Affairs
W@	What?
FCC	Freedom of Choice Coalition
PEI	Prince Edward Island
APP	Appreciate
NBC	National Broadcasting Company
BYOH	Bat you on (the) head
MPA	Medroxyprogesterone acetate
LAS	League of Arab States
IOC	International Olympic Committee
TTLY	Totally
CSII	Continuous subcutaneous insulin infusion
NGO	Non-governmental organization
GR8	Great
ICC	International Chamber of Commerce
NRFF	National Research Foundation for Fertility
CAD	Control + Alt + Delete
ZACE	Zoapatle aqueous crude extract
BBIAF	Be back in a few
IF	Intellectual Freedom
SEO	Search engine optimization
DGA	Don't go anywhere
DN	Down
UNDP	United Nations Development Program
IBEC	International Bank for Economic Cooperation
PPU	Pending pick-up
WNAAC	Women's National Abortion Action Coalition
PSP	Playstation Portable
ScD	Doctor of Science
;S	Gentle warning, like Hmm? What did you say?
AEI	American Enterprise Institute
RTL	Right to Life
YAF	Young America Foundation
WWF	World Wildlife Fund
NCADV	National Coalition Against Domestic Violence
HALP	Help (Discord)
RTWFQ	Read the whole *freaking* question
CSCE	Conference on Security and Cooperation in Europe
JP	Justice of the Peace
SUTH	So use(d) to haters (Facebook)
TSTB	The sooner, the better
UNBLEFBLE	Unbelievable
CPG	Catholic Pharmaceutical Guild
LTOD	Laptop of death
JLC	Juvenile Law Center
IG	Instagram
ZDV	Zidovudine
IRS	Internal Revenue Service
CRW	Council of Religious Women
FOA	Field operating activity
CIN	Cervical intraepithelial neoplasia
HEW	[United States Department of] Health, Education and Welfare
NOLGS	National Organization of Lesbian and Gay Scientists
555	Sobbing, crying. (Mandarin Chinese txt msgs)
?4U	I have a question for you
JBS	John Birch Society
USAF	United States Air Force
CARAL	California Abortion Rights Action League
FIIK	*Freaked* if I know
GTM	Giggling to myself
BF	Best friend
WRU@	Where are you at?
HATTS	Hemagglutination treponemal test for syphilis
420	Lets get high
IRTLF	International Right to Life Federation
CMAP	Cover my *a* partner
RSV	Revised standard version
ABC	American Baby Code
MBS	Mom behind shoulder
P2P	Peer to peer
NSA	No strings attached
ICGI	International Conference on Gender Identity
Z%	Zoo
JK (J/K)	Just kidding
LOL	Laughing out loud
BEU	Benelux Economic Union
ETA	Edited to add
CUDESH	Council for Democratic and Secular Humanism
HOPE	Housing Opportunities for People Everywhere
PATH	Program for Appropriate Technology in Health
EWI	Emailing while intoxicated
PC	Personal computer
FCA	Fellowship of Christian Athletes
ODC	Order of Discalced Carmelites
RTRMT	Retirement (email, Government)
UFMCC	Universal Fellowship of Metropolitan Community Churches
IDDS	Institute for Defense & Disarmament Studies
NBAU	No business as usual
PRESH	Precious
OI	Operator indisposed
IC	I see
TANSTAAFL	There ain't no such thing as a free lunch
H.J.R.	House Joint Resolution
55555	Laughing (In Thai language the number 5 is pronounced 'ha'.)
TGIF	Thank God it's Friday
NEN	Norethindrone acetate
FAA	Foreign Assistance Act
DGYF	Dang, girl you fine
ERP	Erotic Role-Play
FBFR	FaceBook friend
WWNC	Will wonders never cease
QOL	Quality of life
AB	American Birth Control League
UPA	Unwed Parents Anonymous
WTFO	What the *freak* ?, over.
ECE	Economic Commission for Europe
EC	Evangelicals Concerned
DNC	Democratic National Committee
CNS	Central nervous system
UDM	U (You) da (the) man
WK	Week
LWV	League of Women Voters
WVSC	Water vacuum suction curettage
SOWM	Someone with me
PITA	Pain in the *butt*
YABA	Yet another bloody acronym
ARP	Association for Retarded Persons
ITT	In This Thread
L2K	Like to come
NBWHP	National Black Women's Health Project
QUEST	Queers Undertaking Exquisite and Symbolic Transformation
O4U	Only for you
TIC	Tongue-in-cheek
ECAFE	Economic Commission for Asia and the Far East
PLAL	Pro-Life Action League
KOW	Knock on wood
BOP	bind on pickup
UNFAO	United Nations Food and Agricultural Organization
CM	Call me
KJV	King James Version
NINA	No Irish need apply
NFM	None for me / Not for me
BB	Big brother
IFFLP	International Federation for Family Life Promotion
DD	Doctor of Divinity
TARFU	Things Are Really *fouled* Up.
SENPAI	someone older than you, someone you look up to
PPL	People
PND	Prenatal diagnosis
BD	Bachelor of Divinity
IWY	International Women's Year
AHA	American Humanist Association
TMTH	Too much to handle
IMS	I am sorry
JSD	Doctor of Juristic Science
INV	Invite
TA	Transabdominal
PFL	Prayer and Fasting League
MIRV	Multiple independently-targeted reentry vehicles
H8	Hate
DPA	Durable power of attorney
WIIFM	What's in it for me?
GNIGHT	Good night
IHNI	I have no idea
JP	Jackpot (online gaming, bingo games)
PIRG	Public Interest Research Group
CPA	Center for Policy Alternatives
ACE	American Council on Education
MM	Maryknoll Missioners
SDAT	Senile Dementia, Alzheimer's Type
WEBA	Women Exploited By Abortion
IANAC	I am not a crook
KEWL	Cool
ABA	American Booksellers' Association
BT	Between technologies
SD	Sweet dreams
CT	Certified teacher
NGLTF	National Gay and Lesbian Task Force
PLU	People like us
CBPP	Center for Budget and Policy Priorities
LOLO	Lots of love
Cakeday	Birthday (Reddit)
ALG	American Lawyer's Guild
FOE	Fraternal Order of Eagles
AELC	Association of Evangelical Lutheran Churches
WAJ	What a jerk
AATB	American Association of Tissue Banks
SMH	Shaking my head
G/F	Girlfriend
AGS	American Geriatrics Society
ATSITS	All the stars in the sky
JCHA	Joint Committee of Hospital Associations
CD9	Code 9, Meaning parents are around
OPANAL	Organismo para la Proscripcion de las Armas Nucleares en la 
ARC	Archive (compressed files)
CX	Correction
AAFP	American Academy of Family Physicians
1TG, 2TG	number of items needed for win
SALT	Strategic Arms Limitation Talks
OCarm	Order of Carmelites
WAREZ	pirated (illegally gained) software
BBIAM	Be back in a minute
UMC	United Methodist Church
IAWS	Intercollegiate Association of Women Students
TAT	Tray agglutination test
C	[Degrees] Celsius
CDF	Children's Defense Fund
BDEAC	Banque de Developpment des Etats de l'Afrique Centrale
DBP	Defense Budget Project
BOM	*b* of mine
CID	Consider it done
TFTT	Thanks for this tweet (Twitter slang)
PSOS	Parent standing over shoulder
MMK	okay? (as a question)
GDP	Genome Data Base
TAUMUALU	Thinking about you miss you always love you
PROLLY	Probably
AFAP	As far as possible
AAMCH	American Association of Maternal & Child Health
DM	Dungeon Master
MFI	Mad for it
IANAL	I am not a lawyer
CHILD	Christians Helping in Life's Defense
NCAC	National Coalition Against Censorship
OMW	On my way
SA	Salvation Army
EWG	Evil wicked grin (in fun, teasing)
KNIM	Know what I mean?
SPARTECA	South Pacific Regional Trade and Economic Cooperation Agreement
FYA	For your amusement
MWA	Modern Woodmen of America
AA	As above
NEP	New Economic Policy
JMO	Just my opinion
MORF	Male or female?
NSNA	National Student Nurses Association
OM	Oh, my
APA	American Psychiatric Association
M8	Mate
IMU	I miss u (you)
BID	Banco Interamericano de Desarrollo
UNPROFOR	United Nations ProtectionForce
LAV	Lymphadenopathy Virus
P-IUD	Progestagen-releasing intrauterine devices
BGWM	Be gentle with me
LMNK	Leave my name out
PDA	Personal display (of) affection
HBU	How about you?
LLS	Laughing like *silly*
ASAHP	Association of Schools of Allied Health Professions
PLZTLME	Please tell me
CS	Christian Science
NASW	National Association of Social Workers
QN	Queer Nation
Abp	Archbishop
1DR	I wonder
E	Ecstasy
XLR8	faster or going faster
GT	Good try
CW	Conventional wisdom
DNA	Deoxyribonucleic acid
NET-EN	Norethisterone enanthate
CLK	Click
ILGWU	International Ladies' Garment Workers' Union
UGTBK	You've got to be kidding
YAA	Yet another acronym
GRNC	Gay Rights National Lobby
FFP	Friends of Family Planning
CBE	Center for Biomedical Ethics
FRC	Family Research Council
NGF	National Genetics Foundation
OSA	Order of St. Augustine
AFJ	April Fool's joke
KI	Karyopyknotic index
OPEC	Organization of Petroleum Exporting Countries
BM	Basal metabolism
DAoC	Dark Age of Camelot
CARD	Committee Against Registration and the Draft
WHCF	White House Conference on Families
POAHF	Put on a happy face
AYTMTB	And you're telling me this because
AFAM	Ancient Free and Accepted Masons
BIS	Best in slot
MKAY	Mmm, okay
ND	Nice double
BYOD	Bring your own device
KOC	Kiss on cheek
PRON	pornography
MDA	Muscular dystrophy association
NBPTS	National Board for Professional Teaching Standards
AAME	American Academy of Medical Ethics
TBAG	Process of disgracing a corpse, taunting a fragged/killed player
UNOSOM	United Nations Operation in Somalia
GANK	a player ambush or unfair player kill
OTC	Over the counter
DNC	Do not compute (meaning I do not understand)
EGF	Epidermal growth factor
NARAL	National Abortion Rights Action League [formerly the National 
BWS	Better World Society
PAHO	Pan American Health Organization
CURE	Citizens United Resisting Euthanasia
FAS	Fetal alcohol syndrome
KIA	Killed in action
APTN	American Public Television Network
PWN	own
ADA	Americans for Democratic Action
DAFUQ	(What) the *Freak*?
PTMM	Please tell me more
ABC	Already been chewed
14AA41	One for all, and all for one
PD	Peak day
EPC	Environmental Policy Center
DC	Developed country
CD	Congressional district
CSFC	Committee for the Survival of a Free Congress
OI	Osteogenesis imperfecta
ABC	American Broadcasting Company
D2	Dedos / fingers (Spanish SMS)
AVDA	American Venereal Disease Association
RC	Roman Catholic
GAP	Gay Awareness Program
OGC	Office of General Council
CRTI	Center for the Rights of the Terminally Ill
Op	cit Opere citato
NAMBLA	North American Man-Boy Love Association
NCAP	National Community AIDS Partnership
ACLU	American Civil Liberties Union
WCA	Who cares anyway
PECAM	Platelet endothelial cell adhesion molecule
KIT	Keep in touch
CU	Consumer's Union
HAGN	Have a good night
NCFPI	National Clearinghouse for Family Planning Information
ABU	All bugged up
OA	Online auctions (see more auction abbreviations)
TCOY	Take care of yourself
YHBW	You have been warned
j00	You
NSTA	National Science Teachers Association
NPG	Negative Population Growth
EAB	Ethics advisory board
IGP	I got to (go) pee
DNR	Do not resuscitate
PCI	Population Communications International
IDK	I don't know
HGP	Human Genome Project
TYVM	Thank you very much
PTO	Parent Teacher Organization
ITAM	It's The Accounting, Man (financial blogs)
LTLWDLS	Let's twist like we did last summer
IASR	International Academy of Sex Research
RNA	Ribonucleic acid
D46?	Down for sex?
TMB	Text me back
TARS	Thrombocytopenia with absent radii syndrome
NO1	No one
NECLU	National Emergency Civil Liberties Committee
ACA	Arms Control Association
LARFPC	Los Angeles Regional Family Planning Council
BT	Bite this
CEAO	Communaute Economique de l'Afrique de l'Ouest
WHO	World Health Organization
OMB	Office of Management and Budget
NC	Nordic Council
CWA	Concerned Women for America
GBU	God bless you
NW	No way
GTC	Global Tomorrow Coalition, Inc.
ECLA	Economic Commission for Latin America
SYL	Spartacus Youth League
AOA	American Orthopsychiatric Association
SH^	Shut up
PIP	Peeing in pants (laughing hard)
AQAP	As quick (or quiet) as possible
SCUM	Society for Cutting Up Men
FC'INGO	For crying out loud
YGG	You go girl
FW	Forward
PP5	Placental protein 5
AUSCS	Americans United for Separation of Church and State
NORD	National Organization for Rare Disorders
BADEA	Banque Arabe de Developpement Economique en Afrique
iiFAR	Incurably Ill for Animal Research
RTI	Research Triangle Institute
QTPI	Cutie pie
BELF	Blood Elf
OFC	Of course
ISIS	Institute for the Scientific Investigation of Sexuality
AWMA	American Women's Medical Association
PUKS	Pick up kids (SMS)
VIP	Very important person
WEAL	Women's Equity Action League
ACCL	American Citizens Concerned for Life
T.O.P.	[Dominican] Third Order of Penance
WHAM	Women's Health Action Mobilization
NFW	Not for work
WASP	We Are Sexual Perverts
AASHTA	As always, Sheldon has the answer (Bike mechanic Sheldon Brown)
SDS	Students for a Democratic Society
YWCA	Young Women's 'Christian' Association
GL	Good luck
LLD	Doctor of Law
WUP	What's up?
EIS	Environmental impact statement
B&	Banned
HAU	How about you?
IAAA	I am an accountant
VFC	Voters for Choice
AFAIK	As far as I know
SM	Social media
omfglmaobbqrofl	oh my *freaking* god, laugh my *a* off, owned, roll on floor spinning around I'm so sad
PL8	Plate
HCFA	Health Care Financing Administration
WRI	World Resources Institute
IIB	International Investment Bank
E2EG	Ear to ear grin
OHHEMMGEE	Oh My God (alternate of OMG)
ARG	Argument
RX	Regards
FOI	Freedom of Information [Act]
POT	potion
AIM	Accuracy in Media
TSC	Teachers Saving Children
ICRC	International Committee of the Red Cross
TFTI	Thanks for the invitation
WIU	Wrap it up
ARSC	Abortion Survivors Rescue Committee
ASHS	Association of Secular Humanist Societies
FOAD	*Freak* off and die
ACOG	American College of Obstetrics and Gynecology
AI	Artificial insemination
PMS	Pre-menstrual syndrome
UCC	United Church of Christ
USIA	United States Information Agency
AGPA	American Group Psychotherapy Association
RCP	Revolutionary Communist Party [of the U.S.]
PRW	People/parents are watching
TQ	Te quiero / I love you (Spanish SMS)
OMDB	Over my dead body
2	to in SMS
AT&T	Atlantic Telephone and Telegraph
SEM	Scanning electron microscope
OES	Order of the Eastern Star
2M2H	Too much too handle
S-T	Sympto-thermal
LULT	Love you long time
VA	Veterans Administration
SIMYC	Sorry I missed your call
UNOMOZ	United Nations Operation in Mozambique
AA	Ask about
NHS	National Health Service
WISC	Washington Interreligious Staff Council
PEN	[International Association of] Poets, Playwrights, Editors, Essayists, and 
PU	That stinks!
RUOK	Are you okay?
NIMH	National Institute of Mental Health
MSI	Marie Stopes International
NARHC	National Association of Reproductive Health Centers
LFM	Looking for more
HLA	Hola / hello (Spanish SMS)
PK	Psychokinesis
2EZ	Too easy
HL	Half Life
AFGE	American Federation of Government Employees
S4L	Spam for life
ACOP	American College of Osteopathic Pediatricians
WRU	Where are you?
GFC	Gay Father's Coalition
WAA	Women's Action Alliance
FOR	Fellowship of Reconciliation
GTA	Gay Teachers Association
NADT	Not a darn thing
WOMBAT	Waste of money, brains and time
ZZZZ	Sleeping (or bored)
HDDA	Humane and Dignified Death Act
AASECT	American Association of Sex Educators, Counselors and Therapists
ALMA	Adoptee's Liberty Movement Association
ESAD	Eat *S* and die!
NMU	Not much, you?
HAWT	Have a wonderful day (out-dated, see next in list)
RMMM	Read my mail man
ADRDAA	Alzheimer's Disease and Related Disorders Association
P2P	Pay to play
ALF	Animal Liberation Front
IADB	Inter-American Development Bank
CU	See you
GG	Gotta Go
FEMALE	Formerly Employed Mothers at Loose Ends
DKDC	Don't know, don't care
ME	Marriage Encounter
G2R	Got to run
ADMINR	Administrator (Government)
PEEPS	People
GB	Gigabyte
JCL	Licentiate in Canon Law
IYO	In your opinion
MIM	Morality in Media
CTS	Catholic Truth Society
MYO	Mind your own (business)
DDG	Drop dead gorgeous
JJ (J/J)	Just joking
MIA	Missing in action
CEDPA	Centre for Development and Population Activities
ALA	American Library Association
TD2M	Talk dirty to me
TBD	To be determined
DGAF	Don't give a *freak*
121	One-to-one (private chat initiation)
EOT	End of transmission
ST&D	Stop texting and drive
BMA	British Medical Association
AIUM	American Institute of Ultrasound in Medicine
DES	Diethylstilbestrol
GAO	General Accounting Office
CYO	Catholic Youth Organization
CEI	Central European Initiative
BBC	Big bad challenge
SMAZED	Smoky haze (marijuana stoned)
EIFT	Embryo intrafallopian transfer
ACS	American College of Surgeons
CSL	Can't stop laughing
SWAG	free stuff and giveaways from tech tradeshows (definition)
AOM	Age of Mythology
GNE1	Good night everyone
TLB	The Living Bank
Xn	Christian
ACS	Americans for Common Sense
KOTC	Kiss on the cheek
AAP	Always a pleasure
IERA	Inclusive Equal Rights Amendment
HAND	Have a nice day
LAW	Legal Action for Women
PTSD	Post-traumatic stress disorder
RCS	Royal College of Surgeons
BYTM	Better you than me
KNOW	knowledge
LI	LinkedIn
MEZ	mesmerize
INMARSAT	International Maritime Satellite Organization
G7	Group of Seven
TFF	Too *freaking* funny
BL	Belly laugh
ATL	Association of Trial Lawyers
AGP	Association of Gay Psychologists
TTYS	Talk to you soon
UNFICYP	United Nations Force in Cyprus
WAS	Wild *a* guess
BAK	Back at keyboard
NFPC	National Federation of Priests' Councils
MEH	a shrug or shrugging shoulders
TIR	Teacher in room
DAV	Disabled American Veterans
DMPA	Depot-medroxyprogesterone acetate
BG	Big grin
YR	Your
YG	Young gentleman
VFF	Very freaking funny
IG2R	I got to run
WTGP	Want to go private (talk out of public chat area)
HW	Homework
IMAO	In my arrogant opinion
AAK	Asleep at keyboard
MOS	Mother over shoulder
ACP	African, Caribbean, and Pacific Countries
WYHAM	When you have a minute
AFC	Away from computer
NLG	National Lawyer's Guild
^^	read line or read message above
DNR	Dinner (SMS)
NEC	National Ecumenical Coalition
BCFA	Birth Control Federation of America
PRC	People's Republic of China
CE	Council of Europe
WITP	What is the point?
PID	Pelvic inflammatory disease
RW	Renaissance Women
RU	Roussel-Uclaf
NQT	Newly qualified teacher
OIC	Oh, I see
OCSO	Order of Cistercians of the Strict Observance
CMAC	Catholic Marriage Advisory Council
FTFY	Fixed that for you
HIFW	How I felt when... (Used with photo or gif)
HV	Have 
GMTA	Great minds think alike
DW	Dear (or Darling) wife
PMSL	Pee myself laughing
LLM	Master of Law
IV	Intravenous
INRI	Iesus Nazarenus Rex Iudaeorum
PXT	Please explain that
G4C	Going for coffee
BTW	By the way 
PAW	People for the American Way
WLF	Washington Legal Foundation
IDBI	I don't believe it
AWC	After awhile crocodile
B9	Boss is watching
AH	At home
CTN	Can't talk now
JS&A	John Short & Associates, Inc.
PTA	Parent-Teacher Association
GIRL	Guy in real life
ACA	Americans for Constitutional Action
NCCY	National Committee for Children and Youth
SIS	Snickering in silence
DAP	Dial-a-porn
A3	Anytime, anywhere, anyplace
G2GICYAL8ER	Got to go I'll see you later
PRO	Population Renewal Office
BDN	Big darn number
CRA CRA	Slang term meaning crazy
JCB	Bachelor of Canon Law
ALEC	American Legislative Exchange Council
VSC	Voluntary surgical contraception
GLNG	Good luck next game
LGH	Lets get high
USBCA	Until something better comes along
NWRA	National Welfare Rights Association
OTB	Off to bed
IAC	In any case
AIPOP	American Institute of Public Opinion Poll
AMU	Arab Maghreb Union
N2M	Nothing too much
THT	Think happy thoughts
MD	Medical doctor
MCAD	Medium-chain acyl-CoA dehydrogenase deficiency
BF	Boyfriend
RIP	Requiescat in pace
LAPD	Los Angeles Police Department
KK	Knock, knock
GNITE	Good night
DKP	Dragon kill points
VOA	Voice of America
K	of P Knights of Pythias
FPA	Family Protection Act
182	I hate you
SWAG	Scientific wild *a* guess
QT	Cutie
IYD	International Year of the Disabled
PAA	Population Association [or Assistance] of America
SOL	Sooner or later
CMA	Canadian Medical Association
EC	European Community
PI	Pearl Index
@TEOTD	At the end of the day
ATB	All the best
ICYMI	In case you missed it (Twitter slang)
PP/WP	Planned Parenthood/World Population
CCS	Clergy Consultation Service
LLDC	Least developed country
ICBW	It could be worse
ESCAP	Economic and Social Commission for Asia and the Pacific
ILU	I love you
4EAE	Forever and ever 
SAC	State Advisory Committee
FBC	Facebook chat
DM	Doesn't matter
VHEMT	Voluntary Human Extinction Movement
CG	Contadora Group
ACC	Arab Cooperation Council
ICEDI	I can't even discuss it
OECD	Organization for Economic Cooperation and Development
YMCA	Young Men's Christian Association
WDYT	What do you think?
CICO	Coffee in, coffee out
BYOB	Bring your own beer 
BBT	Basal body temperature
CRASH	Center for Reproductive and Sexual Health
FEHB	Federal Employee's Health Benefits
W/B	Welcome back
BBN	Bye, bye now
BOSMKL	Bending over smacking my knee laughing
OYO	On your own
IDC	I don't care
AD	Anno Domini
TLN	The Lavender Network Magazine
MOOS	Member of the opposite sex
OCD	Order of Discalced Carmelites
QFB	Queers fight back
IMCO	Intergovernmental Maritime Consultative Organization
ICC	Interstate Commerce Commission
CAH	Congenital adrenal hyperplasia
IUD	Intra-uterine device
IEP	Inhibin-enriched preparation
NAPARE	National Association for Perinatal Addiction, Research, and Education
CCA	Christian Community Association
JELLY	jealous
OM	Old man
AFFA	Angels Forever, Forever Angels
STOP	Save the Oppressed People
IKR	I know, right?
NANA	Not now, no need
YCT	Your comment to?
NCA	National Committee for Adoption
LMS	Like my status (Facebook)
O	Over
FBF	Facebook friend
BBL	Be back later
LH6	Lets have sex
BACAOR	Bay Area Coalition Against Operation Rescue
RRN	Reproductive Rights Network
SACU	Southern African Customs Union
SNERT	Snot nosed egotistical rude teenager
BM	Bite me
WAP	Whale Adoption Project
NHO	National Hospice Organization
AITR	Adult in the room
SD	Standard deviation
WHO	World Health Organization
RCAR	'Religious' Coalition for Abortion Rights
88	Bye-bye (Mandarin Chinese txt msgs) 
SWL	Screaming with laughter
HC	Holy Communion
FACS	Fellow of the American College of Surgeons
SIECUS	Sex Information and Education Council of the United States
QFI	Quoted for idiocy
TRO	Temporary restraining order
EOL	End of life
G2CU	Good to see you
CHAMPUS	Civilian Health and Medical Program of the Uniformed Services
LC-MS	Lutheran Church-Missouri Synod
AFE	Americans for the Environment
YKWYCD	You know what you can do
BFF	Best friends forever
2G2BT	Too good to be true
Z	Said
VM	Voice mail
OPR	Office of Population Research, Princeton University
TMB	Tweet me back (Twitter slang)
IWALU	I will always love you
WTFE	What the *freak* ever
PRO	Public relations officer
EOM	End of message
10X	Thanks
EFM	Electronic fetal monitoring
BBB	Better Business Bureau
RTRCTV	Retroactive (email, Government)
2MI	Too much information
BAFO	Best and final offer
DHHS	Department of Health and Human Services
AL	Arab League
WP	Warsaw Pact
CPS	Contraceptive Prevalence Surveys
FRCP	Fellow of the Royal College of Physicians, London
CLS	Christian Legal Society
CCF	Cooperative Commonwealth Federation
LBAY	Laughing back at you
GLAAD	Gay and Lesbian Alliance Against Defamation
KMA	Kiss my *a*
ECG	Electrocardiogram
MSG	Message
PCUC	People Concerned for the Unborn Child
CAN	Cult Awareness Network
UNHCR	United Nations Office of the High Commissioner for Refugees
WEU	Western European Union
EO	Executive Order
NWHN	National Women's Health Network
CWYL	Chat with you later
PRC	Population Resource Center
WKD	Weekend
NIGI	Now I get it
GSA	Genetics Society of America
NEH	National Endowment for the Humanities
BD	Big deal
ACLA	American Catholic Lawyers Association
NDA	New drug application
AAS	American Association of Suicidology
NCHS	National Center for Health Statistics
ISTI	International Science and Technology Institute, Inc.
TYFYC	Thank you for your comment
DAE	Does anyone else?
DV	Douay Version
PAT	patrol
YW	You're welcome
CMIIW	Correct me if I'm wrong
AGA	American Gay Atheists
EMP	Electromagnetic pulse
W/O	Without
FIAMC	International Federation of Catholic Medical Associations
PEACE	People Expressing a Concern for Everyone
GD/R	Grinning, ducking, and running
RYO	Roll your own
PVS	Persistent vegetative state
GL/HF	Good luck, have fun 
JDI	Just do it
LLGB	Love, later, God bless
BIO	I'm going to the bathroom (or) Bathroom break
ITYK	I thought you knew
AMOS	Assumptions are the mother of all screwups
BA	Bad *a*
USCRC	United States Civil Rights Commission
LOL	Lots of love
USCSC	United States Civil Service Commission
ANC	African National Congress
C-PLAN	Communist Party Legislative Action Network
SAS	Sisters Against Sexism
GGMSOT	Gotta get me some of that
BORN	Bi-State Operation Rescue Network
GOA	Government Accounting Office
NERPRC	New England Regional Primate Research Center
W/B	Write back
MCH	[Department of] Maternal and Child Health
10Q	Thank you
AAS	Alive and smiling
FARM	Farm Animal Reform Movement
CARR	Coalition Against the Radical Right
GLF	Gay Liberation Front
CFFC	Catholics' for a Free Choice
MAMA	Mothers Against Minor's Abortions
PDS	Please don't shoot
CURLO	See you around like a donut
NAWL	National Association of Women Lawyers
ASA	American Sociological Association
RGC	Repository for Germinal Choice
NWO	No way out
NCLR	National Center for Lesbian Rights
EM	E-mail (Twitter slang)
AOM	Age of majority
TTYAFN	Talk to you awhile from now
PBOOK	Phonebook (e-mail)
SPA-TP	Staphylococcal protein A-IgG
WDYK	What do you know?
DOM	Deo optimo maximo
NR	Nice roll
PHA	Public Housing Administration
YYSSW	Yeah, yeah, sure, sure, whatever
AAI	Alternatives to Abortion International
SKAT	Sex Knowledge and Attitude Test
FFLA	Feminists for Life of America
EI	Eat it
OIB	Oh, I'm back
CR	Calendar rhythm
^5	High-five
LAIA	Latin American Integration Association
MGMT	Management
EPH	Edema/proteinuria/hypertension
PST	Pacific Standard Time
LFG	Looking for group
SRA	Science Research Associates
ABS	American Bible Society
DLBBB	Don't let (the) bed bugs bite
NERF	Changed and is now weaker
GSA	Girl Scouts of America
F2P	Free to play
NICHD	National Institute of Child Health and Human Development
PTL	Praise the Lord
CAHEA	Committee on Allied Health Education and Accreditation
OECS	Organization of Eastern Caribbean States
WDALYIC	Who died and left you in charge
GTC	Gay Teachers Coalition
CBC	Canadian Broadcasting Corporation
NAB	National Association of Broadcasters
2NTE	Tonight
AFT	American Federation of Teachers
PRT	Please Retweet (Twitter slang)
YGTR	You got that right
G	Grand
LIK	liquor
PPD	Post-partum depression
NLT	No later than
PST	Please send tell
PPAF	Planned Parenthood Action Fund
DS	Dear (or Darling) son
MC	Member of Congress
APEC	Asia Pacific Economic Cooperation
NET	Norethindrone
IB	I'm back
AMEND	Moms Experiencing Neonatal Death
ALSE	Advocates for Gay and Lesbian State Employees
LTNS	Long time no see
BRBB	Be right back *babe*
DAD	Dads Against Discrimination
ASC	American Security Council
LYLAS	Love you like a sis
CTC	Care to chat?
143	I love you
TMYL	Tell me your location
SITD	Still in the dark
TV-TEST	Transvaginal tubal embryo stage transfer
AFMCH	American Foundation for Maternal and Child Health
SLBM	Submarine-Launched Ballistic Missiles
