NPG	Negative Population Growth
BBT	Basal body temperature
FSP	Fallopian tube sperm perfusion
DV8	Deviate
AZN	Asian
SPA-TP	Staphylococcal protein A-IgG
IH2F	I have to fart
LFD	Left for day
CAHEA	Committee on Allied Health Education and Accreditation
ROFLCOPTER	Rolling on floor laughing and spinning around
IUB	Intrauterine occlusion body
JAM	Just a minute
AACP	American Academy of Child Psychiatry
ADBB	All done, bye-bye
NS	Nice score
VOC	Victims of Choice
PI	Private investigator
HGP	Human Genome Project
FRC	Family Research Council
TFTI	Thanks for the invitation
CFR	Code of Federal Regulations
HDL	High-density lipoprotein
WFTU	World Federation of Trade Unions
CHA	Christian Holiness Association
H-FDAY	Happy Father's Day
2MI	Too much information
BCR	Benefit-cost ratio
AT	At your terminal
VOA	Voice of America
OT	Old Testament
NCCY	National Committee for Children and Youth
CRS 	Can't remember *stuff*
PRC	People's Republic of China
CEEAC	Communaute Economique des Etats de l'Afrique Centrale
FCAA	Florence Crittenden Association of America
IANAL	I am not a lawyer
CDF	Children's Defense Fund
COH	City of Heroes
NSNA	National Student Nurses Association
LCL	League of Catholic Laymen
SAARC	South Asian Association for Regional Cooperation
CCF	Cooperative Commonwealth Federation
ASHA	American Social Health Association
CMAP	Cover my *a* partner
CAP	Children Awaiting Parents
AISB	As it should be
GNIGHT	Good night
NIGI	Now I get it
PWN	own
TIAD	Tomorrow is another day
OAPEC	Organization of Arab Petroleum Exporting Countries
GTA	Gay Teachers Association
RNC	Republican National Committee
GAMDA	Group Against Media Dishonesty on Abortion
ELI	Environmental Law Institute
APP	Appreciate
MLM	give the middle finger
OPEN	Organization to Promote Equality Now
PHWFL	Public Health Workers for Life
OJ	Only joking
CUA	Catholic University of America
APWU	American Postal Workers Union
HV	Have 
YAF	Young Americans for Freedom
NEW	Network of Empowered Women
ARHP	Association of Reproductive Health Professionals
EOL	End of life
IFRP	International Fertility Research Program
IMO	In my opinion
AOC	Available on cell
TFS	Thanks for sharing
CUMID	See you in my dreams
POT	potion
ABS	American Bible Society
GS	Good shot
SJW	Social justice warrior
NCE	New Catholic Edition
PTO	Personal time off
VVF	Vesico-vaginal fistula
ABT	About
HAGO	Have a good one
FYI	For your information
LI	LinkedIn
ILU	I love you
NBD	No big deal
TMWFI	Take my word for it
DIIK	Darned if I know
JLIC	Jewish Life Issues Committee
NCAC	National Coalition Against Censorship
PMS	Pre-menstrual syndrome
INPLAN	Integrated Population and Development Planning
IBM	International Business Machine
IAAL	I am a lawyer
PROST	Pronuclear stage tubal transfer
MYOB	Mind your own business
BEG	Big evil grin
ITYK	I thought you knew
GNITE	Good night
Facepalm	Used to represent the gesture of smacking your forehead with your palm to express embarrassment or frustration
SART	Society for Assisted Reproductive Technologies
NT	Nice try
NO1	No one
DHS	Demographic and Health Surveys
AG	Andean Group
GIRL	Guy in real life
EBKAC	Error between keyboard and chair
CLS	Critical Legal Studies
LMFAO	Laughing my freaking *a* off
UNRWA	United Nations Relief and Works Agency for Palestine Refugees in the 
CBSS	Council of the Baltic Sea States
BCOY	Big crush on you
WSP	Women Strike for Peace
GnRHa	Gonadotrophin-releasing hormone agonist
AFSCME	American Federation of State, County, and Municipal Employees
CFS	Care for secret?
F	Fart
NECLU	National Emergency Civil Liberties Committee
TBL	Text back later
NAGAP	National Association of Gay Alcoholism Professionals
CWU	Church Women United
DBAU	Doing business as usual
Downvote	Voting negatively on a thread using Reddit’s voting system (Reddit)
PA	Public address
PA	Physicians assistant
RFRA	Religious Freedom Restoration Act
WEU	Western European Union
ANA	American Nurses Association
NFWS	Not for work safe
FUD	Face up deal
P2P	Parent to parent
NT	New Testament
LYSM	Love you so much
HAGO	Have a good one
IF	I farted
UWA	United Way of America
LDO	Like, duh obviously
ICCC	International Concerns Committee for Children
ESA	European Space Agency
TY	Thank you
AMBW	All my best wishes
WIC	Women's International Conference
BCR	Benefit-cost ratio
TAUMUALU	Thinking about you miss you always love you
LCD	Lowest common denominator
SPK	Speak (SMS)
BYOC	Bring your own computer
NEA	National Education Association
EVA	Ever
IAAA	I am an accountant
SNERT	Snot nosed egotistical rude teenager
SPK	Speak (SMS)
KFY	Kiss for you
AAL	American Abolitionist League
FWB	Friend with benefits
VOGUE	Valiant Out Gays United in Energy
AMA	American Medical Association
LSV	Language, sex and violence
AOM	Age of Mythology
AsDB	Asian Development Bank
WITW	What in the world
AFDC	Aid for Families with Dependent Children
NCLR	National Center for Lesbian Rights
AFESD	Arab Fund for Economic and Social Development
SK8RBOI	Skater Boy
W/E	Whatever
OEEC	Organization for European Economic Cooperation
CHILD	Christians Helping in Life's Defense
AGS	American Gynecological Society
PATH	Program for Appropriate Technology in Health
AOG	Assembly of God
IVF-SET	IVF-surrogate embryo transfer
CBS	Columbia Broadcasting System
CNS	Central nervous system
IUCD	Intra-uterine contraceptive device
IFAD	International Fund for Agricultural Development
NARRAL	National Abortion and Reproductive Rights Action League
FART	Floor Assistance Rescue Team
ECOWAS	Economic Community of West African States
HM	His or Her Majesty
UNBLEFBLE	Unbelievable
2M2H	Too much too handle
PAT	patrol
CRTI	Center for the Rights of the Terminally Ill
ARV	AIDS-related virus
FCI	Family Care International, Inc.
YF	Wife
PP/WP	Planned Parenthood/World Population
FUBAR	Fouled up beyond all recognition
ABD	Already been done
MMK	okay? (as a question)
IMTM	I am the man
ME	Marriage Encounter
USCL	United States Coalition for Life
DC	Developed country
ABC	American Baby Code
GTG	Got to go
CBE	Center for Biomedical Ethics
NWLC	National Women's Law Center
WWJD	What would Jesus do?
ZZZZ	Sleeping (or bored)
USBCA	Until something better comes along
RUT	Are u (you) there?
PP/WP	Planned Parenthood/World Population
CPB	Corporation for Public Broadcasting
NADT	Not a darn thing
WUZ	was
LLLI	La Leche League International
PAT	patrol
BOSMKL	Bending over smacking my knee laughing
HIV-Ag	Human immunodeficiency virus antigen
Y2K	You're too kind
YCLIU	You can look it up
GNE1	Good night everyone
W3	WWW (Web address)
CUF	Catholics United for the Faith
WCF	Women's Campaign Fund
BRBB	Be right back *babe*
UFL	University Faculty for Life
COH	City of Heroes
IRS	Internal Revenue Service
UUA	Unitarian Universalist Association
FBO	Facebook official (An official update from Facebook)
TG	Thank goodness
ARM	Abortion Rights Mobilization
SUX	Meanings sucks or it sucks
STR8	Straight
FIAMC	International Federation of Catholic Medical Associations
AYBABTU	All your base are belong to us
CFY	Calling for you
PBS	Public Broadcasting System
NMR	Nuclear magnetic resonance [spectroscopy]
BYOC	Bring your own computer
SAIDS	Simian
NWA	Niggers With Attitude
OFC	Of course
ARF	Animal Rights Front
YGTR	You got that right
UKTR	You know that's right
AFS	American Fertility Society
WISC	Washington Interreligious Staff Council
NBD	No big deal
CLAB	Crying like a baby
CLF	Conservation Law Foundation
CTS	Catholic Truth Society
AMA	American Medical Association
UNCTAD	United Nations Conference on Trade and Development
PTFO	Pass the *freak* out
AAUN	American Association of the United Nations
MIM	Morality in Media
MHOTY	My hat (is) off to you
CNF	Conservation Network Foundation
ITU	International Telecommunication Union
IVH	Intraventricular hemorrhage
P911	Parents coming into room alert
NBWHP	National Black Women's Health Project
SOP	Standard operating procedure
DSI	Development Services International of Canada
MAMA	Mothers Against Minor's Abortions
FAF	Funny as *freak*
SYL	Spartacus Youth League
SOS	Son of Sam
MGMT	Management
ASLM	American Society of Law and Medicine
PVS	Persistent vegetative state
AA	Alcoholics Anonymous
AI	Artificial insemination
FUTAB	Feet up, take a break
2MORO	Tomorrow
ZDV	Zidovudine
IANAC	I am not a crook
KROW	Keep Rockefeller out of Washington
MIA	Missing in action
VGC	Very good condition
LFG	Looking for group
CUF	Catholics United for the Faith
Q	Queue
GS	Good split
AAA	American Adoption Agency
PFL	Prayer and Fasting League
NS	Nice score
URTM	You are the man
^5	High-five
A/N	Author's note
ALCON	All concerned
AAA	American Adoption Agency
TSC	Teachers Saving Children
RLY	Really
EBRD	European Bank for Reconstruction and Development
EE	Engaged Encounter
RTFQ	Read the *freaking* question
WMA	Women's Medical Association
CAD	Short for Canada/Canadian
CO	Conscientious objector
NRL-PAC	National Right to Life Political Action Committee
2	to in SMS
SAT	Scholastic Aptitude Test
TBT	Throwback Thursday (Twitter slang)
AF	As *Freak*
THNQ	Thank-you (SMS)
IHM	[Servants of the] Immaculate Heart of Mary
10Q	Thank you
EOL	End of life
GLE	Good luck everyone
A/S/L	Age/sex/location
TEF	The Environmental Fund
OTP	On the phone
GFI	Go for it
ACK	Acknowledge
IFCA	International Federation of Catholic Alumnae
ADMIN	Administrator
GPOY	Gratuitous picture of yourself
EADB	East African Development Bank
GJ	Good job
KEYA	I will key you later
BCOY	Big crush on you
OOC	Out of character
YGTBKM	You've got to be kidding me
QOL	Quality of life
PPU	Pending pick-up
FBB	Facebook buddy
W/	With
OI	Osteogenesis imperfecta
OLL	Online love
CS	Christian Science
AYSOS	Are you stupid or something?
EZY	Easy
NCCW	National Council of Catholic Women
CPFH	Center for Population and Family Health, Columbia University
CU	See you
FHA	Future Homemakers of America
FWYW	Fart when you want
BBIAS	Be back in a sec
AAS	Alive and smiling
BBC	British Broadcasting Corporation
TBL	Text back later
GGMSOT	Gotta get me some of that
NIE	National Institute for Education
RHIP	Rank has its privileges
TC	Transcervical
RCP	Royal College of Physicians
APA	American Psychoanalytic Association
EDF	Environmental Defense Fund
FTFY	Fixed that for you
AAI	Alternatives to Abortion International
FTBOMH	From the bottom of my heart
KS	Kaposi's Sarcoma
UDDA	Uniform Determination of Death Act
RVN	Republic of Viet Nam
LAPAC	Life Amendment Political Action Committee
KMK	Kiss my keister
OIC	Oh, I see
XLR8	faster or going faster
kB	Kilobyte
WFS	World Fertility Survey
TTLY	Totally
APA	American Psychological Association
RTFM	Read the *freaking* manual
USSR	Union of Soviet Socialist Republics
A/S/L	Age/sex/location
NFPRHA	National Family Planning and Reproductive Health Association
OTB	Off to bed
SSIF	So stupid it's funny
C4N	Ciao for now
AEA	Adoption Exchange Program
PP	Planned Parenthood
FML	*Freak* My Life
CEMA	Council for Mutual Economic Assistance
KIT	Keep in touch
LAIA	Latin American Integration Association
AEAP	As early as possible
EAF	Environmental Action Foundation
FIIOOH	Forget it, I'm out of here
YWHNB	Yes, we have no bananas
KOTL	Kiss on the lips
GDR	Grinning, ducking, and running
YCT	Your comment to?
CRW	Council of Religious Women
LOL	Laughing out loud
AYW	As you want / As you wish
JP	Just playing 
XD	really hard laugh (where D is a smiley mouth)
CSS	Counter-Strike Source
WOC	Women's Ordination Conference
OMW	On my way
FLS	Front Line States
PEN	[International Association of] Poets, Playwrights, Editors, Essayists, and 
ICC	International Chamber of Commerce
FUBAR	Fouled up beyond all recognition
CRE8	Create
PI	Population Institute
OR	Operation Rescue
IRL	In real life
TTG	Time to go
SBT	Sorry 'bout that
NAJSN	National American Jewish Students Network
RTL	Right to Life
F	Fart
VP	Vice President
WEP	Weapon
CVS	Chorionic Villi Sampling
BIBO	Beer in, beer out
WAP	Whale Adoption Project
RD	Rural delivery
FRG	Federal Republic of Germany
CPA	Center for Policy Alternatives
ROFLCOPTER	Rolling on floor laughing and spinning around
WOOMB	World Organization of the Ovulation Method Billings
SSDD	Same stuff, different day
NLT	No later than
FAS	Fetal alcohol syndrome
CCC	Customs Cooperation Council
OMAA	Oh, my aching *A* (butt)
JS&A	John Short & Associates, Inc.
GPHW	Gay Public Health Workers
CEDPA	Centre for Development and Population Activities
OOTD	One of these days
IGADD	Inter-Governmental Authority on Drought and Development
PAC	Political action committee
831	I love you (8 letters, 3 words, 1 meaning)
CSFC	Committee for the Survival of a Free Congress
NICU	Neonatal intensive care unit
CRA CRA	Slang term meaning crazy
IMAO	In my arrogant opinion
KB	Keyboard
SRD	Society for the Right to Die
BG	Big grin
FAB	Fabulous
WWI	Worldwatch Institute
ERIS	Exoatmospheric Reentry Intercept System
S2R	Send to receive (meaning send me your picture to get mine)
EIS	Environmental impact statement
CAN	Cult Awareness Network
BSEC	Black Sea Economic Cooperation Zone
WTGP	Want to go private (talk out of public chat area)
JDI	Just do it
VNH	Very nice hand
SPHA	Solid-phase hemadsorption assay
UF	You farted
LGH	Lets get high
DORIS	Defending Our Rights in the Streets
WAS	Wild *a* guess
ICAM	I couldn't agree more
SA	Sexaholics Anonymous
UT2L	You take too long
LLM	Master of Law
GIC	Gift in crib
SEAL	Sea, Air, Land
NMH	Not much here
DF	Don't fart
HB	Hug back
NCTE	National Council of Teachers of English
JW	Just wondering
KOL	Kiss on cheek
FWHC	Feminist Women's Health Center
OEO	Office of Economic Opportunity
H.J.R.	House Joint Resolution
AWESO	Awesome
BACAOR	Bay Area Coalition Against Operation Rescue
MACS	Multicenter AIDS Cohort Study
RN	Registered nurse
OP	On phone
KISS	Keep it simple, stupid
G/F	Girlfriend
NAS	National Audobon Society
IGAB	Interagency Group for Action on Breastfeeding
PWN	own
TOJ	Tears of joy
PM	Private Message
PLEA	Pro-Life Educational Association
DKP	Dragon kill points
YRYOCC	You're running your own cuckoo clock
SIG2R	Sorry, I got to run
HHS	[United States Department of] Health and Human Services
ARM	Abortion Rights Mobilization
UF	You farted
WFP	Witness for Peace
IMHO	In my humble opinion
PTO	Parent Teacher Organization
404	I don't know
FISH	First in, still here
FAY	*Freak* all you
AFT	American Federation of Teachers
CALM	Custody Action for Lesbian Mothers
INV	Invite
GNSD	Good night, sweet dreams
CIDA	Canadian International Development Agency
TOS	Terms of service
HRT	Hormone replacement therapy
AOA	American Orthopsychiatric Association
LSMT	Life-sustaining medical treatment
ND	Nice double
ROC	Republic of China
CWA	Concerned Women for America
OTC	Over the counter
HIV	Human immunodeficiency virus
GL2U	Good luck to you
GUD	Good 
BHL8	Be home late
PDQ	Pretty darn quick
G2G	Got to go
CW	Conventional wisdom
NERF	Changed and is now weaker
SAC	State Advisory Committee
XLNT	Excellent 
BRT	Be right there
NWSC	National Women's Studies Conference
IFCA	International Federation of Catholic Alumnae
SK8R	Skater
TYVM	Thank you very much
RGR	Roger (I agree, I understand)
LII	Life Issues Institute
VEG	Very evil grin
NGHEF	National Gay Health Education Foundation, Inc.
d00d	Dude
T:)T	Think happy thoughts
ITAM	It's The Accounting, Man (financial blogs)
AASHTA	As always, Sheldon has the answer (Bike mechanic Sheldon Brown)
NASW	National Association of Social Workers
AfDB	African Development Bank
Z	Said
FUAA	Fathers United Against Abortion
UNIKOM	United Nations Iraq-Kuwait Observation Mission
AI	Amnesty International
NWRA	National Welfare Rights Association
DLC	Democratic Leadership Council
OG	Original gangster
AZT	Azidothymidine
GOBs	Good old boys
AAA	Americans Against Abortion
PPNG	Penicillinase-producing Neisseria gonorrhea
OPEC	Organization of Petroleum Exporting Countries
JAMA	Journal of the American Medical Association
TFF	Too *freaking* funny
EPC	Environmental Policy Center
CRA	Center for Reproductive Alternatives
UNA	Use no acronyms
R	are
WRU	Where are you?
STM	Sacrae theologiae masterieus
IH2F	I have to fart
USIA	United States Information Agency
DMPA	Depot-medroxyprogesterone acetate
XOXOXO	Hugs & Kisses
DNC	Do not compute (meaning I do not understand)
OIB	Oh, I'm back
ACLA	American Catholic Lawyers Association
CEO	Chief executive officer
WYGAM	When you get a minute
PBOOK	Phonebook (e-mail)
BAK	Back at keyboard
BIF	Before I forget
YG	Young gentleman
WSP	Women Strike for Peace
FOE	Friends of the Earth
SCUM	Society for Cutting Up Men
ILU	I love you
WADB	West African Development Bank
AVA	American Victims of Abortion
oob	off our backs [Magazine]
RRN	Reproductive Rights Network
BTDT	Been there, done that
iiFAR	Incurably Ill for Animal Research
OIB	Oh, I'm back
FYI	For your information
NBFAB	No bad for a beginner
CLF	Conservation Law Foundation
WIIFM	What's in it for me?
DTR	Define the relationship
CMA	Canadian Medical Association
BF2	Battlefield 2
APWU	American Postal Workers Union
CTO	Check this out
PDW	People's Daily World Magazine
ETA	Estimated time (of) arrival
NRDC	National Resource Defense Council
PCUC	People Concerned for the Unborn Child
FART	Floor Assistance Rescue Team
PC	Player character
GRNC	Gay Rights National Lobby
NACHRI	National Association of Children's Hospitals and Associated Institutions
CULT	Catholics United Against Liberation Theology
YARLY	Ya, really?
SK8RBOI	Skater Boy
PST	Pacific Standard Time
UX	User experience
L2G	(would) Love to go
BAE	Babe or baby
GALA	Gay and Lesbian Alliance
HC	House of Commons
PID	Pelvic inflammatory disease
GRNC	Gay Rights National Lobby
IYC	International Year of the Child
CMON	Come on
IF	Intellectual Freedom
IAO	I am out (of here)
AB	American Birth Control League
HATTS	Hemagglutination treponemal test for syphilis
HAK	Hug and kiss
NOAPP	National Organization on Adolescent Pregnancy and Parenting
E	Enemy
GA	Go ahead
FDA	[United States] Food and Drug Administration
WOMBAT	Waste of money, brains and time
JDL	Jewish Defense League
SETE	Smiling Ear-to-Ear
GTM	Giggling to myself
SF	Someone farted
ELI5	Explain like I'm 5
ARSC	Abortion Survivors Rescue Committee
T:)T	Think happy thoughts
PZA	Pizza
PRB	Population Reference Bureau
GLSA	Gay Law Students Association
APS	Artificial placentation system
YR	Your
PIP	Population Information Program, Johns Hopkins University
JD	Juris Doctor
BEU	Benelux Economic Union
NAAO	National Association of Artist's Organizations
THT	Think happy thoughts
VFC	Voters for Choice
AOTA	All of the above
VIP	Voluntary interruption of pregnancy
CCR	Citizens for Congressional Reform
TSTB	The sooner, the better
SSDD	Same stuff, different day
HC	House of Commons
NWO	No way out
CLW	Council for a Livable World
ASEAN	Association of Southeast Asian Nations
BAM	Below average mentality
SWL	Screaming with laughter
BB	Big brother
NIGI	Now I get it
PRO	Parents' Rights Organization
G4C	Going for coffee
HNL	(w)Hole 'nother level
SRSLY	Seriously
FRCS	Fellow of the Royal College of Surgeons, London
B4	Before
CARAL	California Abortion Rights Action League
UCMU	You crack me up
BIC	Butt in chair
CBC	Congressional Black Caucus
LBS	Laughing, but serious
NMU	Not much, you?
CISS	Chromosomal in-situ suppression hybridization
LMS	Like my status (Facebook)
PMFI	Pardon me for interrupting
LOTI	Laughing on the inside
WRK	Work
DHT	Dihydrotestosterone
GSA	Girl Scouts of America
TYSO	Thank you so much
LNG	Levonorgestrel
SIM	Simian Immunodeficiency Virus
UNCTAD	United Nations Conference on Trade and Development
CEMA	Council for Mutual Economic Assistance
YKW	You know what
NGLTF	National Gay and Lesbian Task Force
IUSSP	International Union for the Scientific Study of Population
143	I love you
LTS	Laughing to self
GSA	General Services Administration
SMHID	Scratching my head in disbelief
HFAC	Holy flipping animal crackers
ED	Erase display
TC	Take care
BYTM	Better you than me
CYE	Check your e-mail
DL	Down low
OMFG	Oh my *freaking* God
S-T	Sympto-thermal
PIE	Paedophiliac International Exchange
DAP	Dial-a-porn
ALCON	All concerned
FINRRAGE	Feminist International Network of Resistance to Reproductive and Genetic
G9	Genius
IVD	Intravas device
CFD	Concern for Dying
LERK	Leaving easy reach of keyboard
ILS	International Life Services
SF	Someone farted
NCHA	National Council on Higher Education
PRW	People/parents are watching
CWOT	Complete waste of time
NRLC	National Right to Life Committee
CMF	Cardinal Mindszenty Foundation
APEC	Asia Pacific Economic Cooperation
GN	Good night
HAU	How about you?
ASAT	Anti-satellite weapons
PA	Prothonotary apostolic
ZC	Zangger Committee
FITB	Fill in the blank
ROTC	Reserve Officers Training Corps
CARICOM	Caribbean Community and Common Market
CPUSA	Communist Party of the United States of America
SIFT	Sperm Intrafallopian Transfer
IFN	Interferon
UNFICYP	United Nations Force in Cyprus
HLF	Human Life Foundation
GOP	Grand Old Party
YTB	You're the best
CEDPA	Centre for Development and Population Activities
INTERPOL	International Criminal Police Organization
GGA	Good game, all
IF	I farted
GNITE	Good night
T+	Think positive
P.C.	Politically correct
et	seqEt sequens
BYOP	Bring your own paint (paintball)
WK	Week
BOAD	Banque Ouest-Africaine de Developpement
AAYF	As always, your friend
R2N2	Reproductive Rights National Network
BAMF	Bad *a* mother *f*
LAAL	Life After [sexual] Assault League
IH2F	I have to fart
55555	Laughing (In Thai language the number 5 is pronounced 'ha'.)
DARE	Dykes Against Racism Everywhere
IUI	Intra-uterine insemination
143	I love you
IWY	International Women's Year
ADDY	Address
DA	The
WLDF	Women's Legal Defense Fund
UNDOF	United Nations Disengagement Observer Force
KISS	Keep it simple, stupid
GFC	Gay Father's Coalition
ETA	Estimated time of arrival
UF	You farted
RFN	Right *freaking* now
LERK	Leaving easy reach of keyboard
PMFJI	Pardon me for jumping in
OTC	Over the counter
CRBT 	Crying really big tears 
88	Bye-bye (Mandarin Chinese txt msgs) 
TLC	Teen Line Connection
SIS	sister
FIIK	*Freaked* if I know
LYLAS	Love you like a sis
H.B.	House Bill
NCI	National Cancer Institute
EOL	End of lecture
EWTN	Eternal Word Television Network
BD	Bachelor of Divinity
AFC	Away from computer
WPS	World Population Society
CIS	Center for Inter-American Security
FCF	Free Congress Foundation
AIR-PLUS	American Information Route Toward a Pro-Life United States
NWF	National Wildlife Federation
POM	Public opinion message
CLD	Could
NFW	No *freaking* way
SBC	School-based clinic
oob	off our backs [Magazine]
MPS	Mucopolysaccharidoses
TFRI	Transnational Family Research Institute
KNIM	Know what I mean?
NIMBY	Not in my back yard
MIRL	Meet in real life
BOT	Be on that
SLBM	Submarine-Launched Ballistic Missiles
DLTBBB	Don't let the bed bugs bite
IAE	In any event
BORN	Bi-State Operation Rescue Network
IGA	International Gay Association
WB	Welcome back
UNDP	United Nations Development Program
G	Grin
P911	Parents coming into room alert
AT&T	Atlantic Telephone and Telegraph
BLNT	Better luck next time
BCNU	Be seeing you
PIC	Picture
EMFBI	Excuse me for jumping in
LTS	Laughing to self
2B	To be
IADB	Inter-American Development Bank
LQTM	Laughing quietly to myself
Y?	Why?
JJA	Just joking around
AMBW	All my best wishes
NSNA	National Student Nurses Association
AHA	American Hospital Association
CJ	Chief Justice
WDYT	What do you think?
ADA	Americans for Democratic Action
UNPROFOR	United Nations ProtectionForce
LGH	Lets get high
BRNC	Be right back, nature calls
AAK	Alive and kicking
NASSP	National Association of Secondary School Principals
TSD	Tay-Sachs Disease
WTF	What the *freak* ?
GHOST	Grand Homosexual Organization to Stop Televangelists
TAU	Thinking about u (you)
L/GHTS	Lesbian and Gay Humanists
2MI	Too much information
TEGWAR	The exciting game without any rules
OPEC	Organization of Petroleum Exporting Countries
TFTF	Thanks for the follow (Twitter slang)
TIA	Thanks in advance
PPP	Planned Parenthood Physicians
QQ (qq) (Q_Q)	crying eyes
DNT	Don't
VGG	Very good game
PVP	Player versus player
USBCA	Until something better comes along
SADC	Southern African Development Community
CUA	See you around
AIUM	American Institute of Ultrasound in Medicine
KFY	Kiss for you
EOT	End of transmission
WTG	Way to go
KIA	Killed in action
NIH	National Institute of Health
NCJW	National Council of Jewish Women
ABEDA	Arab Bank for Economic Development in Africa
X!	a typical woman
HSA	Health Systems Agencies
GRID	Gay-Related Immune Deficiency
RG	Rio Group
IRNFP	International Review of Natural Family Planning
GDP	Genome Data Base
QUEST	Queers Undertaking Exquisite and Symbolic Transformation
AFAIK	As far as I know
OAPP	Office of Adolescent Pregnancy Programs [United States Department of 
LH	Luteinizing hormone
USSR	Union of Soviet Socialist Republics
IB	I'm back
CWRR	'Catholic' Women for Reproductive Rights
IG	Instagram
DPS	Damage per second
CT	Can't talk
CMA	Canadian Medical Association
NCSW	National Conference on Social Welfare
SIM	Simian Immunodeficiency Virus
BYOB	Bring your own beer 
PWA	Person
4EVA	Forever
YHL	You have lost
UER	User effectiveness rate
AIM	American Indian Movement
OTGH	Old-Time Gospel Hour
GL/HF	Good luck, have fun 
CED	Committee for Economic Development
SB	Senate Bill
ICJ	International Court of Justice
IHS	Indian Health Service
TUI	Turning you in
WUF	Where are you from?
ASF	American Suicide Foundation
AVDP	Avoirdupois
BCS	Bethany Christian Services
ELCA	Evangelical Lutheran Church in America
BSEC	Black Sea Economic Cooperation Zone
CSCPA	Committee for Social Change and Political Action
UFWM	You *freaking* with me?
EEOC	Equal Employment Opportunity Commission
PPD	Purified protein derivative
GA	Go ahead
GG	Gotta Go
LLS	Laughing like *silly*
IVF-SET	IVF-surrogate embryo transfer
ES	Erase screen
PAF	Platelet-activating factor
DD	Due diligence
FPWA	Federation of Protestant Welfare Agencies
KEYME	Key me when you get in
UCC	United Church of Christ
CAPD	Continuous ambulatory peritoneal dialysis
FITB	Fill in the blank
WWYC	Write when you can
CDRR	Committee for the Defense of Reproductive Rights
LMAO	Laughing my *a* off
ARF	Animal Rights Front
C-PLAN	Communist Party Legislative Action Network
YR	Your
WL	Whatta loser
HOPING	Helping in Normal Grieving
QFT	Quoted for truth
PEP	Promoting Enduring Peace
FWYW	Fart when you want
AH	At home
ACC	Anyone can come
OES	Order of the Eastern Star
NARRAL	National Abortion and Reproductive Rights Action League
GOL	Giggling out loud
NCHLA	National Committee for a Human Life Amendment
B9	Boss is watching
BBB	Better Business Bureau
PL8	Plate
IRCAR	International Reference Center for Abortion Research
CHOICE	Concern for Health Options, Information, Care and Education
CICRED	Committee for International Cooperation in National Research in 
GOA	Government Accounting Office
ILUM	I love you man
TMI	Too much information
NACAC	North American Council on Adoptable Children
WBS	Write back soon
SQ	Square
ME	Menstrual extraction
CNS	Central nervous system
LLDC	Least developed country
CW	Conventional wisdom
PUKS	Pick up kids (SMS)
AHA	American Humane Association
FSA	Family Service Association
LMFAO	Laughing my freaking *a* off
AATK	Always at the keyboard
AFSC	American Friends Service Committee
PS	Postscriptum
MCCL	Minnesota Citizens Concerned for Life
CLC	Clergy and Laity Concerned
HTH	Hope this helps
VSC	Very soft chuckle
YGG	You go girl
UNIFIL	United Nations Interim Force in Lebanon
NH	Nice hand
WYWH	Wish you were here
GBTW	Get back to work
VOA	Voice of America
NBAU	No business as usual
WASP	We Are Sexual Perverts
NORC	National Opinion Research Center
FTW	For the win
GPA	Grade-point average
1DR	I wonder
SIFT	Sperm Intrafallopian Transfer
SQ	Square
PCS	Population Communication Services, Johns Hopkins University
HIV-Ag	Human immunodeficiency virus antigen
O	hugs
EST	[Werner] Erhardt Sensitivity Training Seminars
YBS	You'll be sorry
APO	Army Post Office
HUB	Head up butt
F	Fart
LOL	Lots of love
WOW	World of Warcraft
BM	Bite me
WIC	Women's International Conference
WYLEI	When you least expect it
121	One-to-one (private chat initiation)
AFPOE	A fresh pair of eyes
MEGO	My eyes glaze over
CD9	Code 9, Meaning parents are around
TA	Transabdominal
RSCJ	Religious of the Sacred Heart of Jesus
VoIP	Voice over Internet Protocol (definition)
CUA	See you around
ACE	marijuana cigarette
MG	Myasthenia Gravis
AGA	American Genetic Association
DGTG	Don't go there, girlfriend
SUP	What's up?
BUBU	Slang term for the most beautiful of women
OPA	Organ Procurement Agency
FYI	For your information
CT	Certified teacher
NYA	National Youth Administration
CURLO	See you around like a donut
DGAF	Don't give a *freak*
CSP	Center for Security Policy
SWALK	Sealed (or sealed) with a loving kiss
NTS	Note to self
FC'INGO	For crying out loud
RFC	Religious Formation Conference
ICOMP	International Council on Management of Population Programmes
WRUD	What are you doing?
NMJC	Nothing much, just chilling
CORE	Congress of Racial Equality
BPOE	Benevolent and Protective Order of Elks
CDC	Centers for Disease Control
CHA	Christian Holiness Association
WDYK	What do you know?
WTT	Want to trade?
MYOB	Mind your own business
PCI	Population Communications International
AISI	As I see it
AU	Angstrom unit
BCFA	Birth Control Federation of America
NRDA	Natural Resources Defense Association
NCADP	National Coalition to Abolish the Death Penalty
UV	Unpleasant visual
182	I hate you
NET-EN	Norethisterone enanthate
ENUF	Enough
GGA	Good game, all
NRCA	Natural Resources Council of America
BAE	Before anyone else
KOS	Kid over shoulder
CERES	Center for Research in Education and Sexuality
M8	Mate
SorG	Straight or Gay?
CUA	Catholic University of America
APHA	American Public Health Association
CD9	Code 9, Meaning parents are around
SJD	Doctor of Juridical Science
GMTA	Great minds think alike
PSS	Peace Science Society
UT	Unreal Tournament
ADIP	Another day in paradise
WYHAM	When you have a minute
IH2F	I have to fart
B/C	Because
OL	Old lady
PXT	Please explain that
IEP	Inhibin-enriched preparation
CMGR	Community manager
PSI	Population Services Institute
ASF	American Suicide Foundation
UNPC	Un- (not) politically correct
WTB	Want to buy
LYLAS	Love you like a sis
CB	Chat break
ME	Menstrual extraction
ESCWA	Economic and Social Commission for Western Asia
UDM	U (You) da (the) man
DGYF	Dang, girl you fine
QIK	Quick
SC	Sisters of Charity
CMIIW	Correct me if I'm wrong
2MOR	Tomorrow
SEM	Scanning electron microscope
WAN2TLK	Want to talk
AA	American Atheists
ADR	Address
BBIAM	Be back in a minute
BC	Because
PROGGY	computer program
LAV	Lymphadenopathy Virus
BAY	Back at ya
SSA	Social Security Administration
CSFC	Committee for the Survival of a Free Congress
SUZI	Sub-zonal insemination
DNA	Deoxyribonucleic acid
RSN	Real soon now
DDC	Dewey Decimal Classification
CNS	Committee for National Security
IOW	In other words
ASHS	Association of Secular Humanist Societies
GR&D	Grinning, running and ducking
CCEL	Christian Civic Education League
ASMA	American Student Medical Association
USMC	United States Marine Corps
CAM	Camera (SMS)
XOXOXO	Hugs & Kisses
RTLC	Right to Life Crusade
AHA	American Humanist Association
CPC	Crisis Pregnancy Center
IMS	I am sorry
AAR	American Academy of Religion
WAJ	What a jerk
CYE	Check your e-mail
RW	Revolutionary Worker Magazine
QQ	Quick question
QT	Cutie
JJA	Just joking around
NCWUS	National Council of Women of the United States
ESCAP	Economic and Social Commission for Asia and the Pacific
WHCH	White House Conference on Hunger
DF	Don't fart
GTM	Giggling to myself
CRF	Constitutional Rights Foundation
ABT2	About to'
MIRL	Me in real life
MOS	Mother over shoulder
SYL	See you later 
UNHCR	United Nations Office of the High Commissioner for Refugees
CHILD	Christians Helping in Life's Defense
PK	Psychokinesis
SPCA	Society for the Prevention of Cruelty to Animals
JCHA	Joint Committee of Hospital Associations
ICS	Institute for Creation Spirituality
FEW	Federally Employed Women
SIS	Snickering in silence
MIC	Maternal and Infant Care
FHA	Federal Housing Administration
WBS	Write back soon
VIP	Voter identification project
CP	Congregation of the Passion
LBVS	Laughing, but very serious
DHHS	Department of Health and Human Services
WTM	Who's the man?
PRO	Public relations officer
AG	Andean Group
WC	Who cares
ALI	American Law Institute
YF	Wife
PSI	Population Services International
GTC	Gay Teachers Coalition
HUYA	Head up your *butt*
IIE	Institute of International Education
FF	Follow Friday (Twitter slang)
FIF	*Freak* I'm funny
DSOC	Democratic Socialist Organizing Committee
GG	Gotta Go
AVDA	American Venereal Disease Association
BCNU	Be seeing you
P.R.	Public relations
ABA	American Booksellers' Association
CSL	Can't stop laughing
VITI	Vaginal intratubal insemination
CIA	Central Intelligence Agency
SO	Significant other
KS	Kaposi's Sarcoma
OP	On phone
CBSS	Council of the Baltic Sea States
HEW	[United States Department of] Health, Education and Welfare
XYL	Ex-young lady, meaning wife. (amateur radio) 
SWAT	Scientific wild *butt* guess
UT	Unreal Tournament
QN	Queer Nation
NCCW	National Council of Catholic Women
Cakeday	Birthday (Reddit)
OTA	Office of Technology Assessment
SOR	Shield of Roses
81	Hells Angels (H=8th letter of alphabet, A=1st letter of alphabet)
NFS	Not for sale
AFDC	American Family Defense Coalition
MCC	Metropolitan Community Church
NON	National Organization of Non-Parents
LD	Later, dude
IMU	I miss u (you)
KT	Katie
SICNR	Sorry, I could not resist
RTSM	Read the stupid manual
W@	What?
ICJ	International Court of Justice
RCS	Royal College of Surgeons
WFP	World Food Program
ZZZZ	Sleeping (or bored)
ALL	American Life League
NSG	Nuclear Suppliers Group
BSA	Boy Scouts of America
NASW	National Association of Social Workers
F	female
PAA	Population Association [or Assistance] of America
CAH	Congenital adrenal hyperplasia
BFFN	Best friend for now
BB	Bebi / Baby (Spanish SMS)
IMNSHO	In my not so humble opinion
WYD	What (are) you doing?
CRA CRA	Slang term meaning crazy
SB	Should be
PRT	Party
K8T	Katie
PZ	Peace 
HOAS	Hold on a second
ZPG	Zero Population Growth
FWB	Friend with benefits
TOU	Thinking of you
IEC	Institutional ethics committee
FRCS	Fellow of the Royal College of Surgeons, London
1TG, 2TG	number of items needed for win
RNA	Ribonucleic acid
NRHP	National Reproductive Health Project
OMI	Oblates of Mary Immaculate
KOC	Kiss on cheek
SRA	State's Rights Amendment
CRIT 	critical hit
TD2M	Talk dirty to me
RU	Are you?
HMO	Health maintenance organization
ADL	Anti-Defamation League [of B'nai B'rith]
BAM	Below average mentality
BIL	Brother in law
WVSC	Water vacuum suction curettage
FAA	Federal Aviation Administration
LLB	Bachelor of Law
ND	Nice double
IC	I see
NTHING	Nothing (SMS)
NCNW	National Council of Negro Women
IOC	International Olympic Committee
WISP	Winning is so pleasurable
n00b	Newbie
GAS	Got a second?
SFRY	Socialist Federal Republic of Yugoslavia
GAS	Gay Alliance of Students
DLBBB	Don't let (the) bed bugs bite
AGPA	American Group Psychotherapy Association
DN	Down
AOM	Age of majority
KK	Knock, knock
RMLB	Read my lips baby
NOPE	National Optimum Population Effort
SADC	Southern African Development Community
FSA	Free Speech Advocates
IAE	In any event
NEH	National Endowment for the Humanities
AA	American Atheists
ALEC	American Legislative Exchange Council
UT2L	You take too long
AFJ	April Fool's joke
GFI	Go for it
CTS	Catholic Truth Society
Z%	Zoo
HLF	Human Life Foundation
O	Opponent
VWP	Very well played
FACOG	Fellow, American College of Obstetrics and Gynecology
NSF	National Science Foundation
WUT	what
EI	Eosinophilic index
K8T	Katie
PFT	Pretty *freaking* tight
BAFO	Best and final offer
AAF	As a friend
HLSC	Human Life Statute Coalition
CLS	Christian Legal Society
TSH	Tripping so hard
UNDP	United Nations Development Program
DUR	Do you remember?
ZDV	Zidovudine
GMBA	Giggling my butt off
ASC	American Security Council
BWL	Bursting with laughter 
CNN	Cable News Network
PPL	Presbyterians Pro-Life
C-PLAN	Communist Party Legislative Action Network
MUSM	Miss you so much
NVM	Never mind
NTL	National Teens for Life
MPH	Master of Public Health
411	information
OGIM	Oh God, it's Monday
JPSA	Joint Program for the Study of Abortion
BATF	Bureau of Alcohol, Tobacco and Firearms
SAIDS	Simian
ILO0	International Labor Organization
TOT	Tubal ovum transfer
CSC	Congregatio Sanctae Crucis
NOWL	knowledge
LDO	Like, duh obviously
TIAD	Tomorrow is another day
FFM	Fund for a Feminist Majority
RYS	Read your screen 
AEU	American Ethical Union
IIB	International Investment Bank
SBT	Sorry 'bout that
ICGI	International Conference on Gender Identity
TLN	The Lavender Network Magazine
UTM	You tell me
NAPSAC	National Association of Parents and Professionals for Safe Alternatives in 
ZOT	Zero tolerance
ATM	At the moment
WOMBAT	Waste of money, brains and time
BOLO	Be on the look out
TRO	Temporary restraining order
T+	Think positive
AMU	Arab Maghreb Union
JBS	John Birch Society
NW	No way
DAD	Dads Against Discrimination
AIPOP	American Institute of Public Opinion Poll
UPC	United Pro-Life Council
L.A.	Latin America
1337	Leet, meaning 'elite'
MEH	a shrug or shrugging shoulders
AWESO	Awesome
BYOH	Bat you on (the) head
SSA	Social Security Act
SA	Salvation Army
AAMOI	As a matter of interest
DHU	Dinosaur hugs (used to show support)
JPSA	Joint Program for the Study of Abortion
GNIGHT	Good night
TIC	Tongue-in-cheek
ALOL	Actually laughing out loud
ISLY	I still love you
CR8	Create
FCI	Family Care International, Inc.
G9	Genius
CTO	Check this out
OMS	On my soul (meaning promise)
OM	Ovulation method
BASOR	Breathing a sigh of relief
WC	Welcome
CSCE	Conference on Security and Cooperation in Europe
IFFLP	International Federation for Family Life Promotion
SU	Shut up
SNCC	Student Non-Violent Coordinating Committee
WARN	Women of All Red Nations
LTD	Living the dream
Msgr	Monsignor
PFL	Prayer and Fasting League
DTR	Define the relationship
F	Fart
NMR	Nuclear magnetic resonance [spectroscopy]
OMGYG2BK	Oh my God, you got to be kidding
INMARSAT	International Maritime Satellite Organization
ICEA	International Childbirth Education Association
ACNM	American College of Nurse-Midwives
DERP	stupid or silly
ALS	Amyotrophic lateral sclerosis
DLTBBB	Don't let the bed bugs bite
UNOSOM	United Nations Operation in Somalia
BSOD	Blue screen of death
TYAFY	Thank you and *freak* you
SCAW	Scientists Center for Animal Welfare
P-FLAG	Parents and Friends of Lesbians and Gays
APL	Adopted People for Life
CCBA	Coalition of Concerned Black Americans
IWO	Institute for World Order
LII	Life Issues Institute
DGTG	Don't go there, girlfriend
BISFLATM	Boy, I sure feel like a turquoise monkey! (unverified)
AP	Associated Press
JCL	Licentiate in Canon Law
Bloke	Man (Discord)
555	Sobbing, crying. (Mandarin Chinese txt msgs)
GTC	Global Tomorrow Coalition, Inc.
NEH	National Endowment for the Humanities
UNFAO	United Nations Food and Agricultural Organization
FOE	Fraternal Order of Eagles
AGA	American Gay Atheists
BFAW	Best friend at work
GnRH	Gonadotrophin-releasing hormone
FTL	For the loss
NFL	National Football League
PLAL	Pro-Life Action League
ADBB	All done, bye-bye
ILO	International Labor Organization
SD	#VALUE!
O4U	Only for you
CMAC	Catholic Marriage Advisory Council
WFS	World Fertility Survey
ZOT	Zero tolerance
PLAL	Pro-Life Action Network
BBQ	Barbeque, Ownage, shooting score/frag
W/O	Without
URSKTM	You are so kind to me
LI	LinkedIn
9	Parent is watching 
EPA	Environmental Protection Agency
G4C	Going for coffee
88	Hugs and kisses
ACC	Arab Cooperation Council
NAM	Nonaligned Movement
CWLA	Child Welfare League of America
ACCT	Agence de Cooperation Culturelle et Technique
MOS	Mother over shoulder
PLMK	Please let me know
CARD	Committee Against Registration and the Draft
j00	You
BAK	Back at keyboard
APHA	American Protestant Hospital Association
VOGUE	Valiant Out Gays United in Energy
KSC	Kind (of) sort (of) chuckle
GS	Good shot
SD	Sweet dreams
BOHICA	Bend over here it comes again!
IUSS	If you say so
ES	Erase screen
NIE	National Institute for Education
ADN	Any day now
POSSLQ	Person of the opposite sex sharing living quarters
FCC	Freedom of Choice Coalition
W/	With
HYFR	Hell yeah, *Freaking* right!
LOL	Laugh out loud
AFLM	Advocates for Life Ministries
TILIS	Tell it like it is
GSA	Genetics Society of America
AFP	[Maternal] alpha-feto protein
LLD	Doctor of Law
ABU	All bugged up
JP	Jackpot (online gaming, bingo games)
AAK	Asleep at keyboard
IM	Instant message
CUL8R	See you later
AOG	Assembly of God
NR	Nice roll
SUP	What's up?
VHEMT	Voluntary Human Extinction Movement
LIK	liquor
NGHC	National Gay Health Coalition
2G2BT	Too good to be true
GB	Goodbye
PLD	Played
WIC	Women, Infants and Children Program
AA	Alcoholics Anonymous
AFJ	Alliance for Justice
OM	Old man
HCFA	Health Care Financing Administration
FPIA	Family Planning International Assistance Program
CIV	Cultures, ideas and values [course]
RFD	Rural free delivery
IDB	Islamic Development Bank
WDALYIC	Who died and left you in charge
ETA	Edited to add
EPH	Edema/proteinuria/hypertension
SIR	Strike it rich
CB	Coffee break
NLT	No later than
CRASH	Committee Against Racism, Sexism, and Heterosexism
LD	Long distance
MHD	Magnetohydrodynamics
RHLA	Respect Human Life Act
AAR	American Academy of Religion
VC	Voice chat
FCC	Freedom of Choice Coalition
EWG	Evil wicked grin (in fun, teasing)
CDF	Children's Defense Fund
FTFY	Fixed that for you
CLK	Click
FB	Facebook
PDQ	Pretty damn quick
AFC	Away from computer
EOD	End of discussion
HLA	Human Life Amendment
@TEOTD	At the end of the day
ILBL8	I'll be late
G+	Google+
ROFLMAO	Rolling on the floor, laughing my *butt* off
BAU	Business as usual
MEZ	mesmerize
NBFO	National Black Feminists Organization
BGWM	Be gentle with me
PBOOK	Phonebook (e-mail)
UNIFEM	United Nations Development Fund for Women
FCC	Federal Communications Commission
ERIS	Exoatmospheric Reentry Intercept System
X	Kiss
CBS	Columbia Broadcasting System
AELC	Association of Evangelical Lutheran Churches
CWYL	Chat with you later
OMDB	Over my dead body
WRI	World Resources Institute
INTRAH	[Program for] International Training in Health, University of North 
KOTC	Kiss on the cheek
H8TTU	Hate to be you
AMEND	Moms Experiencing Neonatal Death
SRA	State's Rights Amendment
RH	Rhesus [positive or negative]
CPE	Council on Population and Environment
UNTAC	United Nations Transitional Authority in Cambodia
BOL	Best of luck
CBE	Center for Biomedical Ethics
SAA	Sexual Addicts Anonymous
FBO	Facebook official (An official update from Facebook)
MM	Sister (Mandarin Chinese txt msg)
WHCH	White House Conference on Hunger
PKU	Phenylketonuria
BFD	Big freaking deal
NGO	Non-governmental organization
JELLY	jealous
USU	Usually
CAN	Cult Awareness Network
SOS	help
RME	Rolling my eyes
BDAY	Birthday
GTG	Got to go
SM	Social media
INC	incoming
WLNC	Women's Leadership Network Conference
DAV	Disabled American Veterans
MCAD	Medium-chain acyl-CoA dehydrogenase deficiency
BBC	Big bad challenge
NIE	Newly industrializing economy
ADA	Adenosine deaminase
ANZUS	Australia-New Zealand-United States Security Treaty
NDA	Natural Death Act
CYAL8R	See you later
SUTH	So use(d) to haters (Facebook)
CAM	Camera (SMS)
APPP	Association of Planned Parenthood Physicians
CODEL	Coordination in Development
CCEL	Christian Civic Education League
AAUN	American Association of the United Nations
MACS	Multicenter AIDS Cohort Study
COPE	Committee on Political Education
OCI	Ovum capture inhibitor
GMA	Gay Militant Atheists
*s*	smile  
BAS	Big 'butt' smile
AOYP	Angel on your pillow
CFS	Care for secret?
ACC	Arab Cooperation Council
SUL	See you later
UNFPA	United Nations Fund for Population Activities
WYD	What (are) you doing?
ECOSOC	Economic and Social Council
TM	Transcendental meditation
AAD	Alliance Against Defamation
WISC	Washington Interreligious Staff Council
BION	Believe it or not
ENUF	Enough
RME	Rolling my eyes
AAP	American Academy of Pediatrics
HLA	Hola / hello (Spanish SMS)
C	Commonwealth
L2P	Learn to play
FEITCTAJ	*Freak* 'em if they can't take a joke
AFAIAA	As far as I am aware
TANK	really strong
EIFT	Embryo intrafallopian transfer
BIC	Butt in chair
LNT	lost in translation
FISH	First in, still here
DTRT	Do the right thing
NDA	Natural Death Act
UOK	(Are) You ok?
AML	All my love
CAD	Short for Canada/Canadian
ASAP	As soon as possible
ICD	Intracervical device
FWYW	Fart when you want
TIC	Tongue-in-cheek
HAWT	sexy or attractive
INTERPOL	International Criminal Police Organization
OJ	Only joking
SQUASH	Super Queers United Against Savage Heterosexuals
DBP	Defense Budget Project
4	Short for for in SMS
QOTD	Quote of the day
IUP	Intrauterine pregnancy
QC	Quality control
IPS	Institute for Policy Studies
GI	Girls Incorporated
FOR	Fellowship of Reconciliation
10M	Ten man
CM	Congregation for the Mission
AWOL	Absent without leave
BISFLATM	Boy, I sure feel like a turquoise monkey! (unverified)
FTL	For the loss
WYCM	Will you call me?
WRT	With regard to
CPUSA	Communist Party of the United States of America
PRM	Physicians for Moral Responsibility
1337	Leet, meaning 'elite'
MUAH	Multiple unsuccessful attempts (at/to) humor
FISH	Fluorescent in-situ hybridization
MEHH	a sigh or sighing
PD	Peak day
QFE	Question for everyone
SRP	Short rib-polydactyly syndrome
121	One-to-one (private chat initiation)
AMFAR	American Foundation for AIDS Research
BFFLNMW	Best friends for life, no matter what
ALMA	Adoptee's Liberty Movement Association
JMO	Just my opinion
CID	Consider it done
OOH	Out of here
CEI	Central European Initiative
UNFAO	United Nations Food and Agricultural Organization
EKG	Electrocardiogram
MIRL	Meet in real life
AFAIAA	As far as I am aware
LMBO	Laughing my butt off
HAK	Hug and kiss
ICC	Interstate Commerce Commission
AAMFT	American Association for Marriage and Family Therapy
SOTMG	Short of time, must go
UNDIESA	United Nations Department of International Economic and Social Affairs 
KISS	Keep it simple, stupid
R8	Rate (SMS)
AWOL	Absent without leave
AAAS	American Association for the Advancement of Science
IMP	Imprimatur
WHATEVES	Whatever
S&M	Sado-masochism
BWMT	Black and White Men Together
GAL	Get a life
TOT	Tubal ovum transfer
SK8R	Skater
ONL	Online
NLG	National Lawyer's Guild
ST&D	Stop texting and drive
JTLYK	Just to let you know
POAHF	Put on a happy face
NTD	Neural tube defect
KS	Kill then steal
AVDP	Avoirdupois
TOJ	Tears of joy
HBD	Happy birthday
EMFBI	Excuse me for jumping in
ACLU	American Civil Liberties Union
DM	Deutsche Mark
LLS	Laughing like *silly*
OMI	Oblates of Mary Immaculate
ACCL	American Citizens Concerned for Life
DM	Doesn't matter
OP	Optimum Population, Inc.
SAT	Sorry about that
MX	Missile, experimental
SEAL	Sea, Air, Land
DSM	Diagnostic and Statistical Manual
SH	Same here
MFS	Mobilization for Survival
NDA	New drug application
JHPIEGO	Johns Hopkins Program for International Education in Gynecology and 
HDDA	Humane and Dignified Death Act
GH	Good hand
EEOC	Equal Employment Opportunity Commission
EC	Evangelicals Concerned
FEW	Federally Employed Women
HIT	Herd of independent thinkers [syndrome]
WRA	Women of reproductive age
DAE	Does anyone else?
DM	Dungeon Master
AIM	Accuracy in Media
MICU	Medical intensive care unit
CBPP	Center for Budget and Policy Priorities
KS	Kill then steal
GGP	Got to go pee
ASHA	American Social Health Association
UN	United Nations
DD	Doctor of Divinity
GBU	God bless you
BVM	Blessed Virgin Mother
OAS	Organization of American States
511	Too much information (more than 411)
EMSG	E-mail message
TM	Trust me
VFF	Very freaking funny
AGS	American Geriatrics Society
Buff	changed and is now stronger
OO	Over and out
ARL	Americans for Religious Liberty
WAP	Women Against Pornography
OHHEMMGEE	Oh My God (alternate of OMG)
APP	Appreciate
GAS	Gay Alliance of Students
GTFOH	Get the *freak* outta here
UCLA	University of California at Los Angeles
IUD	Intra-uterine device
HAG1	Have a good one
NM	Nothing much
FWYW	Fart when you want
ICCR	Interfaith Center on Corporate Responsibility
OCD	Order of Discalced Carmelites
GBU	God bless you
P-IUD	Progestagen-releasing intrauterine devices
RGC	Repository for Germinal Choice
WRA	Women of reproductive age
MAP	More Agricultural Production, Inc.
Feelsgoodman	A social meme that means to feel positive.
IDUNNO	I don't know
C	[Degrees] Celsius
ABTA	Good-bye (signoff)
SELFIE	A photo that is taken of oneself for social media sharing (definition)
GRL	Girl
WHCCY	White House Conference on Children and Youth
UNBLEFBLE	Unbelievable
YIU	Yes, I understand
AFL-CIO	American Federation of Labor and Congress of Industrial Organizations
OAU	Organization of African Unity
STOP	Save the Oppressed People
NET	Norethindrone
AFDC	Aid for Families with Dependent Children
EMBAR	Embarassing
IH2F	I have to fart
ICBW	It could be worse
AMA	Ask me anything (Reddit)
YHBT	You have been trolled
FART	Floor Assistance Rescue Team
IFFS	International Federation of Fertility Societies
OSA	Order of St. Augustine
HV	Humanae Vitae
14AA41	One for all, and all for one
YCDBWYCID	You can't do business when your computer is down
ASAP	As soon as possible
ICAM-1	Intercellular adhesion molecule-1
PDH	Pretty darn happy
UNEP	United Nations Environment Program
SD	Standard deviation
CYA	See you
ACF	Americans for Constitutional Freedom
VSC	Voluntary surgical contraception
4COL	For crying out loud
VSF	Very sad face
FARM	Farm Animal Reform Movement
BBL	Be back later
TT	Trending topic (Twitter slang)
IWSN	I want sex now
K	Okay
IKR	I know, right?
FEHB	Federal Employee's Health Benefits
WNDC	Women's National Democratic Club
AGP	Association of Gay Psychologists
CDB	Caribbean Development Bank
WUF	Where are you from?
VRY	Very
SWAG	free stuff and giveaways from tech tradeshows (definition)
CNP	Continued (in) next post
HW	Homework
2B	To be
NCHA	National Council on Higher Education
Feelsbadman	A social meme that means to feel negative.
YA	Your
LH	Luteinizing hormone
^URS	Up yours
WOMB	Women Opposed to Massacre and Brutality
AAME	American Academy of Medical Ethics
G	Grand
HUGO	Human Genome Organization
YCMU	You crack me up
EFM	Electronic fetal monitoring
LD50	Lethal Dose 50%
TD	Tower defense
TBC	To be continued
DM	Do me
FF	Follow Friday (Twitter slang)
NSFG	National Survey of Family Growth
IF	I farted
WFTU	World Federation of Trade Unions
CHAMPUS	Civilian Health and Medical Program of the Uniformed Services
LMK	Let me know
NEN	Norethindrone acetate
EZ	Easy
CMA	Catholics for a Moral America
SH^	Shut up
BFFLNMW	Best friends for life, no matter what
HV	Have 
GATT	General Agreement on Tariffs and Trade
TURNT	Turn up
GTRM	Going to read mail 
CB	Crazy *b*
ACOP	American College of Osteopathic Pediatricians
B	Be
YOLO	You only live once
SYS	See you soon 
LOTR	Lord of The Rings
FOMC	Falling off my chair
GD	Good
S4L	Spam for life
NAWL	National Association of Women Lawyers
2N8	Tonight
PG	Prostaglandin
GALA	Gay Atheists League of America
AG	Attorney general
UMC	United Methodist Church
NPLD	National Pro-Life Democrats
CPS	Contraceptive Prevalence Surveys
IYO	In your opinion
ECLA	Economic Commission for Latin America
VC	Voice chat
AVC	American Veterans Committee
ATB	All the best
JK (J/K)	Just kidding
TL	Too long
JP	Justice of the Peace
E123	Easy as one, two, three
ITOP	Induced termination of pregnancy
FW	Forward
NCHS	National Center for Health Statistics
CORE	Congress of Racial Equality
CSL	Can't stop laughing
CACM	Central American Common Market
HIV	Human immunodeficiency virus
QSL	Reply 
1UP	extra life
ET	Embryo transfer
USGPO	United States Government Printing Office
MOO	My own opinion
SMHID	Scratching my head in disbelief
DMNO	Dude Man No Offense
BAU	Business as usual
ECOSOC	[United Nations] Economic and Social Council
GLE1	Good luck everyone
WCL	World Confederation of Labor
YW	You're welcome
MFS	Mobilization for Survival
AYT	Are you there?
OIC	Organization of the Islamic Conference
SELA	Sistema Economico Latinoamericana
FEC	Federal Elections Commission
BVM	Blessed Virgin Mother
^^	read line or read message above
MX	Missile, experimental
XYZ	Examine your zipper
LAS	League of Arab States
IMNSHO	In my not so humble opinion
SH^	Shut up
BYOD	Bring your own device
DAM	Don't annoy me
UR	You are / You're
KEWL	Cool
XYZ	Examine your zipper
POIDH	Picture, or it didn't happen
CCR	Citizens for Congressional Reform
T4BU	Thanks for being you
DD	Due diligence
ODC	Order of Discalced Carmelites
V	Very
IDBI	I don't believe it
YR	Yeah right
EI	Eat it
NWHN	National Women's Health Network
W/END	Weekend
WBU	What about you?
TYT	Take your time
FWYW	Fart when you want
WRU@	Where are you at?
AYOR	At your own risk
CARE	Co-operative for American Remittances to Everywhere
1CE	Once
XME	Excuse Me
KOL	Kiss on cheek
FAF	Funny as *freak*
WMA	Women's Medical Association
BWS	Better World Society
NHANES	National Health and Nutrition Examination Survey
UPA	Unwed Parents Anonymous
PRT	Party
DYNWUTB	Do you know what you are talking about?
WAREZ	pirated (illegally gained) software
WIC	Women, Infants and Children Program
TOTES	Totally
AANS	American Academy of Neurological Surgeons
AORN	American Association of Registered Nurses
H8	Hate
BOL	Best of luck
BTA	But then again
TTYL	Talk to you later
NICM	National Institute for Campus Ministries
CHK	Check
Buff	changed and is now stronger
ARE	Acronym rich environment
OTOH	On the other hand
POM	Public opinion message
FTA-Abs	Fluorescent treponemal antibody-absorption
WAH	Working at home
LEAD	League for Economic Assistance and Development
WRAP	White Ribbon Campaign Against Pornography
USCC	United States Catholic Conference
WC	Welcome
LLM	Master of Law
BCOS	Because
BA	Bad *a*
WMA	World Medical Association
CBTV	Coalition for Better Television
RU	Roussel-Uclaf
PRC	Population Resource Center
TRUTH	Teens Rescuing Unborn Tiny Humans
COMECON	Coordinating Committee on Export Controls
RRC	Reproductive Rights Coalition
EST	Eastern standard time
MEH	a shrug or shrugging shoulders
IF	I farted
UNMOGIP	United Nations Military Observer Group in India and Pakistan
PP5	Placental protein 5
YWSYLS	You win some, you lose some
YGG	You go girl
MA	Master of Arts
TSNF	That's so not fair
IVF-DO	IVF-donor ova
WAS	Wait a second
NCAC	National Coalition Against Censorship
BIB	Boss is back
TCB	Take care of business
NCCB	National Council of Catholic Bishops
DNT	Don't
CCC	Customs Cooperation Council
ILY	I love you
ACP	African, Caribbean, and Pacific Countries
AARP	American Association of Retired Persons
UUA	Unitarian Universalist Association
NAPWA	National Association of People with AIDS
CRB	Come right back
NFS	National Fertility Study
DACOWITS	Defense Advisory Committee on Women in the Services
STM	Sympto-thermal method
TARAL	Texas Abortion Rights Action League
PSYOPS	Psychological operations
O	Over
IMU	I miss u (you)
NCGLC	National Coalition of Gay and Lesbian Counselors
HRH	His or Her Royal Highness
HB	Hurry back
RL	Real life
P2P	Pay to play
AIH	Artificial insemination
NFM	None for me / Not for me
AFAIC	As far as I am concerned
NSW	New South Wales
AAP	Always a pleasure
MAR	Mixed antiglobulin reaction
GAS	Greetings and salutations
TBH	To be honest
CONRAD	Contraceptive Research and Development Program, Eastern Virginia 
FBF	Flashback Friday
LHSX	Lets have sex
TAT	Tray agglutination test
FA	Fundamentalists Anonymous
NCAP	National Community AIDS Partnership
CT	Can't talk
CSII	Continuous subcutaneous insulin infusion
OIC	Oh, I see
UTM	You tell me
H2CUS	Hope to see you soon
C&G	Chuckle & grin
PAU	Pan American Union
UTI	Urinary tract infection
PRW	People/parents are watching
WEEBO	Describes a person obsessed with of Japanese culture
CP	Congregation of the Passion
UHGTBSM	You have got to be s#$t*ing me!
IWAWO	I want a way out
BIDS	Birth Defects Information System
NPFC	National Pro-Family Coalition
SAARC	South Asian Association for Regional Cooperation
ANC	African National Congress
V	Very
OSF	Order of St. Francis
DNR	Do not resuscitate
BIOYN	Blow it out your nose
MIT	Massachusetts Institute of Technology
VAT	Value added tax
GLA	Good luck all
LIMT	Laugh in my tummy
ZOG	Zionist Occupation Government
NVM	Never mind
BT	Bite this
BOE	bind on equip
NN	Nicaraguan Network
WAWA	Where are we at?
SDMB	Sweet dreams, my baby
TLC	Tender loving care
ILO	International Labor Organization
NBAU	No business as usual
GIFT	Gamete intra-fallopian transfer
CR	Calendar rhythm
DYFM	Dude, you fascinate me
WOA	Work of Art
NRLC	National Right to Life Committee
NEP	New Economic Policy
WTO	World Tourism Organization
AOC	Available on cell
B	Back
XD	a devilish smile
CMB	Call me back
DERP	stupid or silly
TMYL	Tell me your location
20	location
AFT	American Federation of Teachers
C-Span	Congressional Coverage Cable Network
DILLIGAF	Do I look like I give a *freak*?
DF	Don't even go there
MAD	Mutual assured destruction
SKAT	Sex Knowledge and Attitude Test
CU2	See you
SDMB	Sweet dreams, my baby
AAMOF	As a matter of fact
APA	American Pharmaceutical Association
NAAO	National Association of Artist's Organizations
CURE	Citizens United Resisting Euthanasia
LNG	Levonorgestrel
1TG, 2TG	number of items needed for win
IV	Intravenous
OCarm	Order of Carmelites
IDBI	I don't believe it
CURLO	See you around like a donut
NIROK	Not in reach of keyboard
ASRC	Abortion Survivors Rescue Committee
DL	Dead link
PAPP-A	Pregnancy-associated plasma protein-A
ImL	(in Arial font) Means I love you (a way of using the American sign language in text)
NAJSN	National American Jewish Students Network
EGF	Epidermal growth factor
FUD	Face up deal
AIPOP	American Institute of Public Opinion Poll
BCIE	Banco Centroamericano de Integracion Economico
TA	Thanks a lot
FAA	Foreign Assistance Act
ALA	American Library Association
ROFL	Rolling on floor laughing
CHD	Campaign for Human Development
BIS	Best in slot
GUM	Great unwashed masses
LOA	List of acronyms
GLF	Gay Liberation Front
GGMSOT	Gotta get me some of that
AAHS	Americans Against Human Suffering
G	Giggle
TTUL	Talk to you later
L8RG8R	Later, gator
UNICEF	United Nations Children's Emergency Fund
CERES	Center for Research in Education and Sexuality
IOW	In other words
AE	Artificial embryonation
VNH	Very nice hand
ZUP	What's up?
UF	You farted
CU	Consumer's Union
QL	Quit laughing
CONUS	Continental United States
MoD	March of Dimes
CHK	Check
PAS	Post-abortion syndrome
JFF	Just for fun
MC	Member of Congress
RW	Real world
AAK	Alive and kicking
LOL	Laugh out loud
LTOT	Low tube ovum transfer
SOMARC	Social Marketing for Change
ALADI	Asociacion Latinoamericana de Integracion;
DMY	Don't mess yourself
MA	Master of Arts
HLC	Human Life Center
WATS	Wide Area Telephone System
FWYW	Fart when you want
ZPG	Zero Population Growth
D2	Dedos / fingers (Spanish SMS)
OPM	Office of Personnel Management
ACOG	American College of Obstetrics and Gynecology
YCHT	You can have them
GBTW	Get back to work
Abp	Archbishop
PRB	Population Reference Bureau
WAJ	What a jerk
PROBS	Probably
NPG	Negative Population Growth
ILYSM	I love you so much
ATEOTD	At the end of the day
YSIC	Your sister in Christ
IMAP	[International Planned Parenthood Federation] Medical Advisory Board 
MS	Multiple sclerosis
LSMT	Life-sustaining medical treatment
QED	Quod erat demonstrandum
PPP	Planned Parenthood Physicians
86	Over
ESAD	Eat *S* and die!
AAMCH	American Association of Maternal & Child Health
IMO	In my opinion
FAAK	Falling asleep at keyboard
WUCIWUG	What you see is what you get
FUBB	Fouled up beyond belief
SLAA	Sex and Love Addicts Anonymous
BELF	Blood Elf
APO	Army Post Office
CPG	Catholic Physicians Guild
PU	That stinks!
OCC	Order of Calced Carmelites
2N8	Tonight
UNIDO	United Nations International Development Organization
EEC	European Economic Community
URH	You are hot (U R Hot)
MEH	a so-so or just okay
PPD	Purified protein derivative
IRTLF	International Right to Life Federation
SA	Spontaneous abortion
MBS	Mom behind shoulder
IGN	I (I've) got nothing
BOYF	Boyfriend
VITI	Vaginal intratubal insemination
AH	At home
ACTH	Adrenocorticotropic hormone
LIC	Like I care
YW	You're welcome
OTFL	On the floor laughing
WLF	Washington Legal Foundation
MMK	okay? (as a question)
NOWL	knowledge
FHA	Future Homemakers of America
SWAK	Sent (or sealed) with a kiss
CYEP	Close your eyes partner
WWJD	What would Jesus do?
ICYMI	In case you missed it (Twitter slang)
NACHO	North American Conference of Homophile Organizations
EO	Executive Order
UCLA	University of California at Los Angeles
HBU	How about you?
TANK	really strong
BF	Best friend
EOD	End of day
VWD	Very well done
DOT	Damage over time
YAA	Yet another acronym
NSW	New South Wales
AIH	Artificial insemination
NGHC	National Gay Health Coalition
HCG	Human chorionic gonadotrophin
ESF	Economic support funds
GAC	Get a clue
NSM	National Survey of Men
WWI	Worldwatch Institute
SBIA	Standing back in amazement
STFU	Shut the *freak* up
UN4TUN8	Unfortunate
CAP	Committee for American Principles
ASIG	And so it goes
BB	Be back
CRIT 	critical hit
NEA	National Endowment for the Arts
DC	District of Columbia
PLEA	Pro-Life Educational Association
ABBR	abbreviation
DINK	Double-income, no kids
SIG2R	Sorry, I got to run
FU	*Freak* you
DoD	Department of Defense
CBTV	Coalition for Better Television
ACHR	American Convention on Human Rights
HSG	Hysterosalpingogram
DXNRY	Dictionary
ProPAC	Progressive Political Action Committee
SH	Same here
LH6	Lets have sex
DW	Dear (or Darling) wife
ASAP	As soon as possible
ODC	Order of Discalced Carmelites
ASA	Association for the Study of Abortion
ONUSAL	United Nations Observer Mission in El Salvador
ARV	AIDS-related virus
ALC	American Lutheran Church
ALF	Animal Liberation Front
GALA	Gay Atheists League of America
AEA	Adoption Exchange Program
FYA	For your amusement
B2C	Business-to-consumer
ISLY	I still love you
C4N	Ciao for now
MSSVD	Medical Society for the Study of Venereal Diseases
OMW	On my way
NBPTS	National Board for Professional Teaching Standards
omfglmaobbqrofl	oh my *freaking* god, laugh my *a* off, owned, roll on floor spinning around I'm so sad
ATP	Adenosine triphosphate
CAEU	Council of Arab Economic Unity
KTF	Keep the Faith
YNK	You never know
FRT	For real though
NFPFA	Natural Family Planning Federation of America
L/GHTS	Lesbian and Gay Humanists
PMSL	Pee myself laughing
BRB	Be right back
DSS	Delayed Shock Syndrome
MRW	My reaction when... (Used with photo or gif)
GD	Good
B8	Bait (person teased or joked with, or under-aged person/teen)
H&K	Hugs & kisses
F	Fart
AA	Ask about
PLZTLME	Please tell me
NEA	Nuclear Energy Agency
BOB	Back off *buddy*
OS	Operating system
420	Lets get high
MCHR	Medical Committee for Human Rights
WUU2	What are you up to?
GLAAD	Gay and Lesbian Alliance Against Defamation
JLIC	Jewish Life Issues Committee
<3	sideways heart (love, friendship)
BB	Big brother
GEA	Gay Educators Association
BOYF	Boyfriend
IFC	International Finance Corporation
OPEC	Organization of Petroleum Exporting Countries
GAFC	Get a *freaking* clue
ASAHP	Association of Schools of Allied Health Professions
FACS	Flourescence-activated cell sorter
ECLAC	Economic Commission for Latin America and the Caribbean
FBM	Fine by me
FTBOMH	From the bottom of my heart
NYPLC	National Youth Pro-Life Coalition
TTTT	These things take time
CE	Council of Europe
BSOD	Blue screen of death
ANM	Auxiliary nurse-midwife
MOSS	Member of same sex
BCS	Bethany Christian Services
MSH	Management Sciences for Health
MDA	Muscular dystrophy association
F	Fart
FIMH	Forever in my heart
WYCM	Will you call me?
R	are
WHATEVES	Whatever
BIP	Basic infertile pattern
AE	Area effect
UNDP	United Nations Development Program
IIIO	Intel inside, idiot outside
LD	Later, dude
YWCA	Young Women's 'Christian' Association
ROK	Republic of Korea
BIRTH	Born Individuals Rescuing the Helpless
FIF	*Freak* I'm funny
EMILY	Early Money is Like Yeast
SD	Standard deviation
NCDC	National Catholic Development Conference
NIFOC	Naked in front of computer
STOPP	Stop Planned Parenthood
UNIKOM	United Nations Iraq-Kuwait Observation Mission
NICHD	National Institute of Child Health and Human Development
FRT	For real though
PWA	Person
SCI-COP	Committee for the Scientific Investigation of Claims of the Paranormal
QFB	Queers fight back
AAME	American Academy of Medical Ethics
GN	Good night
DDG	Drop dead gorgeous
JP	Jackpot (online gaming, bingo games)
NE1	Anyone
STFU	Shut the *freak* up
BBS	Be back soon
RG	Rio Group
BSF	But seriously folks
NRDA	Natural Resources Defense Association
55555	Crying your eyes out (Mandarin Chinese txt msgs)
L8R	Later
IH2F	I have to fart
NC	Nice crib
W/B	Welcome back
ISIS	Institute for the Scientific Investigation of Sexuality
CWLA	Child Welfare League of America
FLE	Family Life Education
FA	Fundamentalists Anonymous
MM	Maryknoll Missioners
HHIS	Head hanging in shame
P	Partner
AZT	Azidothymidine
YCLIU	You can look it up
ASEAN	Association of Southeast Asian Nations
WPC	World Population Council
IUD	Intra-uterine device
BBS	Be back soon
CMB	Call me back
WITCH	Witches' International Conspiracy from Hell
CHAMPVA	Civilian Health and Medical Program of the Veterans Administration
PI	Pearl Index
OCart	Order of Carthusians
MC	Merry Christmas
H.B.	House Bill
IVF-DS	IVF-donor sperm
NSC	National Security Council
BM	Basal metabolism
GTFO	Get the *freak* out
KJV	King James Version
USCRC	United States Civil Rights Commission
CS	Christian Science
C/P	Cross post
IFGR	International Foundation for Genetic Research
FACE	Freedom of Access to Clinic Entrances [Act]
SF	Someone farted
TFR	Total fertility rate
SYL	Spartacus Youth League
GLE1	Good luck everyone
L2G	Like to go?
PMFI	Pardon me for interrupting
NIRS	Nuclear Information Resource Service
TARAL	Texas Abortion Rights Action League
CALC	Clergy & Laity Concerned
FOA	Field operating activity
USCSC	United States Civil Service Commission
HVH	Heroic Violet Hold
GMV	Got my vote
SOMY	Sick of me yet?
ARAC	Animal Rights Activists for Choice
NINA	No Irish need apply
OB	Oh brother
AANFP	American Academy of Natural Family Planning
NGLTF	National Gay and Lesbian Task Force
UPS	Uterine progesterone system
ICEDI	I can't even discuss it
K	of P Knights of Pythias
VBS	Very big smile
SG	Surgeon General
MRT	Modified ReTweet  (Twitter slang)
FOLKS	Friends of Little Kids
DF	Don't fart
JCB	Bachelor of Canon Law
TL;DR	Too long; didn't read
OBV	Obviously
86	Over
ACS	American College of Surgeons
LD50	Lethal Dose 50%
404	I don't know
NWHN	National Women's Health Network
MLM	give the middle finger
GAC	Get a clue
WRK	Work
RD	Rural delivery
UNA	Use no acronyms
MINURSO	United Nations Mission for the Referendum in Western Sahara
FFS	For *freak'*sakes
ECA	Economic Commission for Africa
AWOL	Away without leaving
MEHH	a sigh or sighing
SKAT	Sex Knowledge and Attitude Test
MKAY	Mmm, okay
GNP	Gross national product
QQ (qq) (Q_Q)	crying eyes
GR&D	Grinning, running and ducking
OFC	Of course
NIAAA	National Institute of Alcohol Abuse and Alcoholism
OEEC	Organization for European Economic Cooperation
XME	Excuse Me
DF	Don't fart
GD/R	Grinning, ducking, and running
G2TU	Got to tell u (you)
GNE1	Good night everyone
ETO	Estimated time of ovulation
POPTECH	Population Technical Assistance Project
B/F	Boyfriend
IOMH	In over my head
AKA	Also known as
ACS	Americans for Common Sense
PTL	Praise the Lord
GRWG	Get right with God
BIOYA	Blow it out your *a*
WWNC	Will wonders never cease
HOW	Happiness of Womanhood
UNPC	Un- (not) politically correct
LNMP	Last normal menstrual period
FOLKS	Friends of Little Kids
CNF	Conservation Network Foundation
BOT	Back on topic
IF	I farted
CARAL	Canadian Abortion Rights Action League
SOAB	Son of a *B*
DCL	Doctor of Canon Law
LOLH	Laughing out loud hysterically
R	[Degrees] Rankin
LLGB	Love, later, God bless
NCLR	National Center for Lesbian Rights
AYBABTU	All your base are belong to us
IYKWIM	If you know what I mean
SF	Someone farted
GP	General practitioner
IAEA	International Atomic Energy Agency
PCA	Permanent Court of Arbitration
IF	I farted
CTSA	Catholic Theological Society of America
NS	Nice split
CULA	See you later alligator
D46?	Down for sex?
kB	Kilobyte
SIMYC	Sorry I missed your call
BG	Big grin
UCMU	You crack me up
S2S	Sorry to say
CUT	Church Universal and Triumphant
ARMS	Abortion-Related Ministries
OTW	Off to work
G-77	Group of 77
ROFL	Rolling on floor laughing
GAL	Get a life
GCC	Gulf Cooperation Council
BMA	British Medical Association
DIS	Did I say?
F2P	Free to play
EI	Eat it
TIPPS	Technical Information Population for the Private Sector
e.g.	Exempli gratia
ANM	Auxiliary nurse-midwife
IA8	I already ate
MoD	March of Dimes
RATS	Radical [AIDS] Activist Truth Squad
PHA	Public Housing Administration
ASHG	American Society of Human Genetics
SLAPP	Strategic lawsuit against public participation
CM	Call me
CB	Chat break
OMB	Office of Management and Budget
SM	Society of Mary
N1	Nice one
AA	As above
JC (J/C)	Just checking
GDABM	Global Defense Against Ballistic Missiles
NORML	National Organization for the Repeal of Marijuana Laws
ThD	Doctor of Theology
AFAP	As far as possible
SU	Shut up
IVF-DE	IVF-donor embryo
NCCJ	National Conference of Christians and Jews
WUCIWUG	What you see is what you get
DBEYR	Don't believe everything you read
KK	Okay, Okay!
IIB	International Investment Bank
PST	Pacific Standard Time
SIR	Strike it rich
WTG	Way to go
NGL	Not gonna (going to) lie
SMEXI	Combination of sexy and Mexican, used to describe attractive people
NSGC	National Society of Genetic Counselors
NACC	North Atlantic Cooperation Council
BBIAM	Be back in a minute
APTN	American Public Television Network
CCD	Confraternity of Christian Doctrine
TC	Transcervical
CWU	Church Women United
CMEA	Council for Mutual Economic Assistance
ERS2	Eres tz / are you (Spanish SMS)
EOS	End of show
TBA	To be announced
CFD	Concern for Dying
1NAM	One in a million
GL/HF	Good luck, have fun 
NC	Nice crib
IDGAF	I don't give a *freak*
SAMA	Student American Medical Association
UCS	Union of Concerned Scientists
MOD	Moderator
F2F	Face to face
AML	All my love
FWIW	For what it's worth
TTYS	Talk to you soon
TYAFY	Thank you and *freak* you
USSR/EE	USSR/Eastern Europe
LMMFAO	Laughing my mother freaking a** off
ITAM	It's The Accounting, Man (financial blogs)
BME	Based on my experience
E123	Easy as one, two, three
CARICOM	Caribbean Community and Common Market
BT	Bite this
ETA	Estimated time (of) arrival
j00	You
DARE	Drug Abuse Resistance Education
CCD	Confraternity of Christian Doctrine
JSD	Doctor of Juristic Science
MBA	Master of Business Administration
C&G	Chuckle & grin
ACK	Acknowledge
WL	Whatta loser
USPS	United States Postal Service
DIY	Do it yourself
GPO	[United States] Government Printing Office
SOAB	Son of a *B*
OM	Oh, my
BB/BSA	Big Brothers/Big Sisters of America
LMMFAO	Laughing my mother freaking a** off
BCO	Big crush on
SCLC	Southern Christian Leadership Conference
RIP	Rest in peace
BN	Bad news
WEBA	Women Exploited By Abortion
XYL	Ex-young lady, meaning wife. (amateur radio) 
VFC	Voters for Choice
ATL	Association of Trial Lawyers
FFA	Free for all
IRNFP	International Review of Natural Family Planning
FPWA	Federation of Protestant Welfare Agencies
14AA41	One for all, and all for one
NANN	National Association of Neonatal Nurses
FW	Forward
EF4T	Effort
ICJ	International Court of Justice
WCA	Who cares anyway
JTLYK	Just to let you know
N2M	Nothing too much
BA	Bad *a*
DEIS	Draft environmental impact statement
LOLH	Laughing out loud hysterically
WHO	World Health Organization
AYT	Are you there?
HL	Half Life
FZ	Franc Zone
NAPARE	National Association for Perinatal Addiction, Research, and Education
OSB	Order of St. Benedict
EPK&C	Early prenatal karyotype farenand cell scan
ACE	American Council on Education
AMF	Arab Monetary Fund
EMA	E-mail address (Twitter slang)
SUYF	Shut up you fool
PBS	Public Broadcasting System
UPI	United Press International
HF	Have fun
INFACT	Infant Formula Coalition
YA	Your
WIIFM	What's in it for me?
IWSN	I want sex now
APSH	Association for Persons with Severe Handicaps
IB	I'm back
ABT	About
WGACA	What do you think?
?	I have a question
YMMV	Your mileage may vary
HLSC	Human Life Statute Coalition
AORN	American Association of Registered Nurses
BDN	Big darn number
TY	Thank you
SG	Surgeon General
NSM	National Survey of Men
AATK	Always at the keyboard
PNAP	Prolife Nonviolent Action Project
HL	House of Lords
ICBW	It could be worse
EFTA	European Free Trade Association
WTFO	What the *freak* ?, over.
KNIM	Know what I mean?
ECMO	Extracorporeal membrane oxygenation
ITT	In This Thread
GLSA	Gay Law Students Association
CCS	Clergy Consultation Service
APAC	All praise and credit
OSV	Our Sunday Visitor [Magazine]
WNDC	Women's National Democratic Club
VBL	Visible bra line
MC	Member of Congress
NCCC	National Coalition of Clergy and Laity
RTI	Research Triangle Institute
ASPEN	American Society for Parenteral and Enteral Nutrition
UF	You farted
AAR	At any rate
TU	Thank you
IFFS	International Federation of Fertility Societies
UPS	Uterine progesterone system
CIN	Cervical intraepithelial neoplasia
AFPOE	A fresh pair of eyes
DG	Dei Gratia
YMCA	Young Men's Christian Association
SWS	Sociologists for Women in Society
OI	Operator indisposed
APA	American Pharmaceutical Association
NATO	North Atlantic Treaty Organization
?	I don't understand what you mean
YARLY	Ya, really?
G7	Group of Seven
CSSP	Center for Studies of Suicide Prevention
AD	Anno Domini
ELI	Environmental Law Institute
UV	Unpleasant visual
CID	Criminal Investigation Department
ABA	American Bar Association
PLAN	Protect Life in All Nations
NGF	National Genetics Foundation
SB	Smiling back
AYS	Are you serious?
SM	Social media
B4N	Bye for now
AAMOF	As a matter of fact
AGI	agility
GLA	Good luck all
YAF	Young Americans for Freedom
FBF	Facebook friend
NFL	National Federation for Life
RC	Roman Catholic
FOCA	Freedom of Choice Act
LFD	Left for day
PKMN	Pokemon
LARFPC	Los Angeles Regional Family Planning Council
PEP	Promoting Enduring Peace
BB/BSA	Big Brothers/Big Sisters of America
PLAN	Protect Life in All Nations
Z	Zero
459	Means I love you (ILY is 459 using keypad numbers)
BOP	bind on pickup
AG	Attorney general
ECWA	Economic Commission for Western Asia
NE	Any
19	Zero hand
420	Marijuana
PPFC	Planned Parenthood Federation of Canada
WCCL	Wisconsin Citizens Concerned for Life
HRU	How are you?
SB	Smiling back
LFG	Looking for guard
H2CUS	Hope to see you soon
BT	Between technologies
RBAY	Right back at you
NCAN	National Coalition of American Nuns
APCW	Adolescent Pregnancy Childwatch Project
IWHC	International Women's Health Coalition
DSOC	Democratic Socialist Organizing Committee
TPTB	The powers that be
ACL	American Collegians for Life
FART	Floor Assistance Rescue Team
CICO	Coffee in, coffee out
IAETF	International Anti-Euthanasia Task Force
BOM	*b* of mine
EWG	Evil wicked grin (in fun, teasing)
SC	Stay cool
HF	Have fun
NE	Any
LTNS	Long time no see
ACA	Americans for Constitutional Action
UNTSO	United Nations Truce Supervision Organization
TAM	Tomorro a.m.
NEET	Nafarelin European Endometriosis Trial Group
VA	Veterans Administration
UMC	United Methodist Church
RU	Are you?
ME	Marriage Encounter
IBRC	Infant Bioethical Review Committee
CSC	Civil Service Commission
LOLWTF	Laughing out loud (saying) What the *freak*?
TNT	Til next time
IUI	Intra-uterine insemination
CUSA	Cavitron ultrasonic surgical aspirator
ECE	Economic Commission for Europe
RCS	Royal College of Surgeons
TOY	Thinking of you
CPM	Cesarian Prevention Movement
SSSS	Society for the Scientific Study of Sex
SNAFU	Situation normal
WIBNI	Wouldn't it be nice if
GTC	Global Tomorrow Coalition, Inc.
GAP	Gay Awareness Program
IVD	Intravas device
BFG	Big  freaking grin
L.A.	Latin America
GMC	General Medical Council
UNFICYP	United Nations Force in Cyprus
ICD	Intracervical device
SPR	Society for Psychical Research
RH	Rhesus [positive or negative]
GDR	German Democratic Republic
HUYA	Head up your *butt*
PIP	Peeing in pants (laughing hard)
RAPID	Resources for the Awareness of Population Impacts on Development
CAEU	Council of Arab Economic Unity
WCA	Who cares anyway
TANKING	owning
TOU	Thinking of you
PLZ	Please
IYQ	I like you
NP	No problem
ALL	American Life League
UX	User experience
NORCL	National Organization for the Repeal of Cocaine Laws
DC	District of Columbia
APP	Application
NIC	Newly industrializing country
TLC	Teen Line Connection
JJ (J/J)	Just joking
UL	Upload
MYO	Mind your own (business)
VBAC	Vaginal birth after Cesarian [section]
DC	Disconnect
EE2	Ethinyl estradiol
EZY	Easy
IMSB	I am so bored
RT	Retweet (Twitter slang)
CUL	See you later
D&C	Dilatation and curettage
FOE	Friends of the Earth
BOM	Billings Ovulation Method
ARC	American Red Cross
BAFO	Best and final offer
AL	Arab League
d00d	Dude
F2P	Free to play
AAS	Abortion Abolition Society
PAHO	Pan American Health Organization
IAC	In any case
ROTFL	Rolling on the floor laughing
BFF	Best friends forever
AED	Academy for Educational Development
INRI	Iesus Nazarenus Rex Iudaeorum
WB	Welcome back
DFL	Dead *freaking* last
NPR	National Public Radio
LRF	Luteinizing releasing factor
SSINF	So stupid it's not funny
NM	Never mind
UPU	Universal Postal Union
AAFP	American Academy of Family Physicians
BAMF	Bad *a* mother *f*
CYO	See you online
CUL	See you later
OTT	Over the top
ADMIN	Administrator
DNR	Do not resuscitate
TD	Tower defense
LIC	Like I care
BM	Bite me
FFP	Friends of Family Planning
AWMA	American Women's Medical Association
TTFN	Ta ta for now
RX	Regards
SF	Someone farted
PND	Prenatal diagnosis
RCAR	'Religious' Coalition for Abortion Rights
WYSIWYG	What you see is what you get 
P	Partner
TIET	Transvaginal intratubal embryo transfer
FIL	Father in law
BFAW	Best friend at work
TTUL	Talk to you later
RX	drugs or prescriptions
USAF	United States Air Force
WEAL	Women's Equity Action League
CRB	Come right back
ALERT	American Life Education and Research Trust
WAS	Wild *a* guess
NRC	National Research Council
WTT	Want to trade?
FYEO	For your eyes only
DM	Deutsche Mark
AFDC	American Family Defense Coalition
ALG	American Lawyer's Guild
ORLY	Oh really?
F	[Degrees] Fahrenheit
TMYL	Tell me your location
DKDC	Don't know, don't care
VFM	Value for money
AACP	American Academy of Child Psychiatry
AMF	Arab Monetary Fund
ADR	Address
TSC	Teachers Saving Children
AEAP	As early as possible
DF	Don't even go there
GTW	Multiglycosides of Tripterygium wilfordii
ITYK	I thought you knew
WWF	World Wildlife Fund
MCHR	Medical Committee for Human Rights
TYSO	Thank you so much
POC	Products of conception'
NFS	Need for Speed
NAM	New age movement
CO	Conscientious objector
MGB	May God bless
ABC	American Broadcasting Company
CPC	Crisis Pregnancy Center
L2P	Learn to play
VBS	Very big smile
BWMT	Black and White Men Together
SICNR	Sorry, I could not resist
G2CU	Good to see you
Op	cit Opere citato
RN	Registered nurse
555	Sobbing, crying. (Mandarin Chinese txt msgs)
LOL	Laughing out loud
YIU	Yes, I understand
EIB	Excellence in Broadcasting [Network]
FRG	Federal Republic of Germany
BIB	Boss is back
NHO	National Hospice Organization
ACA	Arms Control Association
DF	Don't fart
LLD	Doctor of Law
NWRA	National Welfare Rights Association
OP	Order of Preachers
SACU	Southern African Customs Union
L2K	Like to come
FEMALE	Formerly Employed Mothers at Loose Ends
LVM	Left voice mail
511	Too much information (more than 411)
PROLLY	Probably
CULA	See you later alligator
NSFG	National Survey of Family Growth
GB	Goodbye
AA	As above
APA	American Psychoanalytic Association
SAA	Society for Applied Anthropology
IMO	International Maritime Organization
AASECT	American Association of Sex Educators, Counselors and Therapists
AU	Angstrom unit
AfDB	African Development Bank
SPHA	Solid-phase hemadsorption assay
CCAR	Central Conference of American Rabbis
AFAIUI	As far as I understand it
STD	Sexually-transmitted disease
IFYP	I feel your pain
ALL	American Life Lobby
FWYW	Fart when you want
H.J.R.	House Joint Resolution
MP	Mana points
HLC	Human Life Center
HZA	Hemizona assay
CEP	Council on Economic Priorities
PA	Public address
OECS	Organization of Eastern Caribbean States
DAoC	Dark Age of Camelot
IIED	International Institute for Environment and Development
PTL	Praise the Lord
TTYL	Talk to you later
CAH	Congenital adrenal hyperplasia
VA	Veterans Administration
IGA	International Gay Association
E	Ecstasy
VFW	Veterans of Foreign Wars
COMECON	Coordinating Committee on Export Controls
IAWS	Intercollegiate Association of Women Students
BB	Bebi / Baby (Spanish SMS)
WTS	Want to sell?
BBT	Basal body temperature
START	Strategic arms reduction treaty
NAC	Network Action Committee
JT (J/T)	Just teasing
SELA	Sistema Economico Latinoamericana
OCC	Order of Calced Carmelites
CD	Congressional district
STB	Sacrae theologiae baccalaureus
IVIG	Intravenous immunoglobulin
TANKING	owning
ISTI	International Science and Technology Institute, Inc.
PND	Prenatal diagnosis
OSU	Order of St. Ursula
AFAP	As far as possible
Q4U	(I have a) question for you
IMCO	Intergovernmental Maritime Consultative Organization
ZOMG	Used in World of Warcraft to mean OMG (Oh My God)
YT	You there?
GGOH	Gotta Get Outa Here
PIH	Pyridoxal isonicotinoyl hydrazone
JD	Juris Doctor
ARAL	Association to Repeal Abortion Laws
JFF	Just for fun
OT	Occupational therapy
OC	Oral contraceptive
UFMCC	Universal Fellowship of Metropolitan Community Churches
TWSS	That's what she said
FISH	Fluorescent in-situ hybridization
Z%	Zoo
ICCR	Interfaith Center on Corporate Responsibility
CRLP	Center for Reproductive Law and Policy
HAND	Have a nice day
GWHTLC	Glad we had this little chat
NO1	No one
UFB	Un *freaking* believable
IOMH	In over my head
PAHO	Pan American Health Organization
AAS	American Association of Suicidology
WADB	West African Development Bank
MS	Master of Science
TDTM	Talk dirty to me
NHI	National Health Insurance
DNA	Deoxyribonucleic acid
FOR	Fellowship of Reconciliation
CSII	Continuous subcutaneous insulin infusion
K	Okay
KB	Kick butt
COB	Close of business
IISHR	International Institution for the Study of Human Reproduction
WAWA	Where are we at?
FSH	Follicle-stimulating hormone
SPTO	Spoke to
BFN	Bye for now
0.02	My (or your) two cents worth
WUU2	What are you up to?
FEBS	Federation of European Biochemical Societies
CIV	Cultures, ideas and values [course]
SK8NG	Skating
FY	Fiscal year
AAMOI	As a matter of interest
SENPAI	someone older than you, someone you look up to
k/b	Keyboard
WWNC	Will wonders never cease
NAC	Network Action Committee
O	hugs
GLNG	Good luck next game
Op	cit Opere citato
FZ	Franc Zone
FWYW	Fart when you want
D.A.	District attorney
BFFL	Best friends for life
BA	Bachelor of Arts
YKWYCD	You know what you can do
PCO	Polycystic ovary syndrome
LY	Love ya 
NQT	Newly qualified teacher
LTL	Laparoscopic tubal ligation
LLDC	Least developed country
DPA	Durable power of attorney
ACF	Americans for Constitutional Freedom
FBB	Facebook buddy
FWHC	Feminist Women's Health Center
WP	Warsaw Pact
RSCJ	Religious of the Sacred Heart of Jesus
1UP	extra life
CHCE	Center for Health Care Ethics
MIRV	Multiple independently-targeted reentry vehicles
NOLSW	National Organization of Legal Social Workers
EC	European Community
PDQ	Pretty darn quick
NCGSTDS	National Coalition of Gay Sexually-Transmitted Disease Services
SS	Saints
RS	Runescape
PA	Power of attorney
ACNM	American College of Nurse-Midwives
SPTO	Spoke to
SP1	Pregnancy-specific beta 1-glycoprotein
10X	Thanks
ACP	African, Caribbean, and Pacific Countries
TEF	The Environmental Fund
APLIC	Association for Population/Family Planning and Information Centers
KOS	Kill on sight
UNAVEM	United Nations Angola Verification Mission
TFTI	Thanks for the invitation
FAS	Federation of American Scientists
PLAL	Pro-Life Action League
NICA	National Interfaith Coalition on Aging
PPPPPPP	Proper prior planning prevents putrid poor performance
ACE	American Council on Education
MNSG	Mensaje (message in Spanish)
OECD	Organization for Economic Cooperation and Development
FLS	Front Line States
SOS	help
UF	You farted
ISIS	Institute for the Scientific Investigation of Sexuality
CYAL8R	See you later
GG	Good Game
IRL	In real life
CBC	Canadian Broadcasting Corporation
FOE	Fraternal Order of Eagles
MRW	My reaction when... (Used with photo or gif)
GOMB	Get off my back
ARC	AIDS-Related Complex
OAU	Organization of African Unity
IGHT	I got high tonight
GF	Girl friend
KDFU	Means Cracking (K) the (D as in Da) *freak* up
SO	Significant other
PCC	Population Crisis [or Control] Committee
JP	Just playing 
PSS	Peace Science Society
WTB	Want to buy
CRW	Council of Religious Women
CTFA	Cosmetic, Toiletry, and Fragrance Association
UPUSA	United Presbyterians USA
SF	Someone farted
BAG	Busting a gut
ED	Erase display
YABA	Yet another bloody acronym
NAMBLA	North American Man-Boy Love Association
JAC	Just a second
AAMFT	American Association for Marriage and Family Therapy
AWOL	Absent without leave
IGF	Insulin-like growth factor
CCBA	Coalition of Concerned Black Americans
RUMOF	Are you male or female?
NORD	National Organization for Rare Disorders
HUB	Head up butt
K	of P Knights of Pythias
ASRC	Abortion Survivors Rescue Committee
SHID	Slapping head in disgust
ASLA	Age/sex/location/availability
FWM	Fine with me
CPG	Catholic Pharmaceutical Guild
1DR	I wonder
GEEP	Gonadotropin-releasing hormone agonist and exogenous estradiol and
T4BU	Thanks for being you
AE	Artificial embryonation
RW	Renaissance Women
DL	Dead link
OP	Order of Preachers
RTRCTV	Retroactive (email, Government)
TTET	Transvaginal-transmyometrial embryo transfer
LMNK	Leave my name out
EPK&C	Early prenatal karyotype farenand cell scan
OPEN	Organization to Promote Equality Now
YBIC	Your brother in Christ
F	Fart
PK	Psychokinesis
OAS	Organization of American States
NPR	National Public Radio
MORF	Male or female?
SPA-TP	Staphylococcal protein A-IgG
EQ	EverQuest
AFK	Away from keyboard
SENPAI	someone older than you, someone you look up to
SLAA	Sex and Love Addicts Anonymous
ARHO	Association of Reproductive Health Officials
EIB	Excellence in Broadcasting [Network]
ABC	Already been chewed
SEM	Scanning electron microscope
NIC	Newly industrializing country
PIR	Parents in room
HCS	Human chorionic somatomammotropin
DAP	Dial-a-porn
IDC	I don't care
B2B	Business-to-business
BAE	Babe or baby
AOH	Ancient Order of Hibernians
IVH	Intraventricular hemorrhage
SAR	Sexual attitude restructuring
URH	You are hot (U R Hot)
LABIA	Lesbians and Bisexuals in Action
GRATZ	Congratulations
SIDS	Sudden Infant Death Syndrome
IDTS	I don't think so
UL	Upload
SPST	Same place, same time
IFAD	International Fund for Agricultural Development
PIR	Parents in room
EE2	Ethinyl estradiol
OM	Old man
FWP	First world problems
4EVA	Forever
PMS	Pre-menstrual syndrome
OMG	Oh my gosh
GTA	Gay Theatre Alliance
NAB	National Association of Broadcasters
GB	Gigabyte
RT	Roger that
Y	Yawn
ICS	Institute for Creation Spirituality
HRU	How are you?
KTF	Keep the Faith
NORD	National Organization for Rare Disorders
FACP	Fellow of the American College of Physicians
WUW	What u (you) want?
AI	Artificial insemination
4NR	Foreigner 
NMA	National Medical Association
GI	Government issue
TARFU	Things Are Really *fouled* Up.
TNSTAAFL	There's no such thing as a free lunch
AFLM	Advocates for Life Ministries
LULZ	joke, or for laughs
EMILY	Early Money is Like Yeast
RYS	Are you single?
GORK	God only really knows
GATT	General Agreement on Tariffs and Trade
PZ	Peace 
AFK	Away from keyboard
STOPP	Stop Planned Parenthood
PC	Personal computer
SAM	Society for Adolescent Medicine
IVF	In-vitro fertilization
GCC	Gay Community Center
BWS	Better World Society
OP	Optimum Population, Inc.
ELISA	Enzyme-linked immunosorbent assay
AT	At your terminal
GWHTLC	Glad we had this little chat
LEMENO	Let me know
AFL	Adolescent Family Life
EMP	Electromagnetic pulse
GUD	Good 
EVA	Ever
CICO	Coffee in, coffee out
BEG	Big evil grin
BFFN	Best friend for now
CRASH	Center for Reproductive and Sexual Health
AFP	[Maternal] alpha-feto protein
PKMN	Pokemon
ECAFE	Economic Commission for Asia and the Far East
CHEER	Center for Homosexual Education, Evaluation and Research
KDFU	Means Cracking (K) the (D as in Da) *freak* up
YTG	You're the greatest
PTA	Parent-Teacher Association
BRNC	Be right back, nature calls
NCJW	National Council of Jewish Women
ABC	American Baby Code
AWOL	Absent without leave
APC	American Parents Committee
CASE	Christian Advocates Serving Evangelism
PD	Peak day
IGN	I (I've) got nothing
D46?	Down for sex?
NRFF	National Research Foundation for Fertility
YAF	Young America Foundation
FFM	Fund for a Feminist Majority
FAM	Fertility awareness method
CG	Contadora Group
SDI	Strategic Defense Initiative
NLG	National Lawyer's Guild
IG2R	I got to run
CG	Contadora Group
MCH	[Department of] Maternal and Child Health
KPC	Keeping parents clueless
MGMT	Management
KSC	Kind (of) sort (of) chuckle
TOTS	Tubal ovum transfer of sperm
WOA	Work of Art
ALD	Adrenoleukodystrophy
BC	Be cool
UF	You farted
G2R	Got to run
DW	Dear (or Darling) wife
F	Fart
CHAUS	Catholic Health Association of the United States
GLAD	Gay and Lesbian Awareness Da
SAR	Sexual attitude restructuring
411	information'
CLS	Christian Legal Society
BGCS	Boyhood Gender Conformity Scale
WTFE	What the *freak* ever
POV	Point of view
HLB	Human Life Bill
AWMA	American Women's Medical Association
LAW	Legal Action for Women
GIAR	Give it a rest
TLC	Tender loving care
MPA	Master of Public Administration
RTNTN	Retention (email, Government)
PLU	People like us
WAT	What
KMT	Kiss my tushie
JFGI	Just *freaking* Google it
IWY	International Women's Year
RTLC	Right to Life Crusade
MTF	More to follow
EOS	End of show
EEG	Electroencephalogram
HTLV	Human T-Cell Lymphotropic Virus
NATO	North Atlantic Treaty Organization
Y	Yawn
CAPD	Continuous ambulatory peritoneal dialysis
PCA	Presbyterian Church in America
NCWUS	National Council of Women of the United States
OT	Off topic (discussion forums)
TIL	Today I learned
CHSA	Consumer Health Service of America
FRI	Family Research Institute
AHA	American Historical Association
TFTF	Thanks for the follow (Twitter slang)
GTSY	Great (or good) to see you 
AFL	Adolescent Family Life
GANK	a player ambush or unfair player kill
NCC	National Council of Churches
NCADV	National Coalition Against Domestic Violence
PCO	Polycystic ovary syndrome
NET-EN	Norethisterone enanthate
BIBO	Beer in, beer out
WTH	What the heck?
MSW	Master of Social Work
PDS	Please don't shoot
S'OK	It' (s) okay (ok)
ASPEN	American Society for Parenteral and Enteral Nutrition
UDI	Unidentified drinking injury (meaning bruise, scratch, ache and so on)
JV	Joint venture
AFAIK	As far as I know
HAU	How about you?
MYO	Mind your own (business)
ABBR	abbreviation
AFZ	Acronym Free Zone
IDUNNO	I don't know
AI	Artificial intelligence
FML	*Freak* My Life
QFI	Quoted for irony
SOWM	Someone with me
POIDH	Picture, or it didn't happen
NSISR	Not sure if spelled right
SWAT	Scientific wild *butt* guess
HBD	Happy birthday
UN4TUN8	Unfortunate
AUL	Americans United for Life
ACA	Americans for a Constitutional Amendment
BS	Bachelor of Science
BFFL	Best friends for life
F	Fart
PTIYPASI	Put that in your pipe and smoke it
FC	Fingers crossed
DR	Didn't read
ICGI	International Conference on Gender Identity
MEP	Multiple exposure photography
WRI	World Resources Institute
PAW	People for the American Way
THX	Thanks
TMB	Tweet me back (Twitter slang)
OT	Old Testament
TTTT	These things take time
IYD	International Year of the Disabled
FWYW	Fart when you want
IMHO	In my humble opinion
CEPGL	Communaute Economique des Pays des Grands Lacs
POC	Products of conception'
^5	High-five
FCA	Fellowship of Christian Athletes
NAACP	National Association for the Advancement of Colored People
TIL	Today I learned
2M2H	Too much to handle
Bloke	Man (Discord)
AVDA	American Venereal Disease Association
FEHB	Federal Employee's Health Benefits
WEP	Weapon
DYJHIW	Don't you just hate it when...?
GOI	Get over it
TRO	Temporary restraining order
LWV	League of Women Voters
AC	Acceptable content
PEI	Prince Edward Island
2M2H	Too much too handle
TPM	Tomorrow p.m.
HMO	Health maintenance organization
IH2F	I have to fart
LAW	Legal Action for Women
NERF	Changed and is now weaker
TSH	Tripping so hard
IME	Institute of Medical Ethics
FUBAR	Fouled up beyond all recognition
IG	Instagram
IFC	International Finance Corporation
RRN	Reproductive Rights Network
CPS	Contraceptive Prevalence Surveys
NBC	National Broadcasting Company
ECWA	Economic Commission for Western Asia
KOTL	Kiss on the lips
CEPGL	Communaute Economique des Pays des Grands Lacs
RMMM	Read my mail man
MBS	Mutual Broadcasting System
EAF	Environmental Action Foundation
VRY	Very
AF	Aggression factor
WWF	World Wildlife Fund
SF	Someone farted
RM	Reichsmark
NCA	National Committee for Adoption
DM	Do me
URC	University Research Corporation
YSYD	Yeah sure you do
GCC	Gulf Cooperation Council
ProPAC	Progressive Political Action Committee
INSERM	Institut National de la Sant:e et de la Recherche Medicale
S&M	Sado-masochism
AASK	Aid to Adoption of Special Kids
AFA	American Family Association
GAU	Gay Academic Union
W/B	Write back
SMSA	Standard Metropolitan Statistical Area
NCCC	National Council of Catholic Charities
BTYCL	Bootycall'
PDH	Pretty darn happy
LRF	Luteinizing releasing factor
B/C	Because
COR	Coalition on Revival
O	Opponent
DAV	Disabled American Veterans
YL	Young lady
NARW	National Assembly of Religious Women
OSM	Order of the Servants of Mary
GTA	Gay Theatre Alliance
7K	Sick
CP	Communist Party
G/F	Girlfriend
FC	Full card
W/B	Write back
NPC	National People's Congress
ZC	Zangger Committee
FWP	First world problems
GM-CSF	Granulocyte-macrophage colony-stimulating factor
WWJD	What Would Judd Do? (Artist Donald Judd, who was known to do things in his own compulsive way.)
CRA	Center for Reproductive Alternatives
URA*	You are a star
G	Grin
IV	Intravenous
YNK	You never know
PZA	Pizza
LMAO	Laughing my *a* off
ALSE	Advocates for Gay and Lesbian State Employees
EOM	End of message
CARR	Coalition Against the Radical Right
DIY	Do it yourself
2NTE	Tonight
WRU@	Where are you at?
SA	Sexaholics Anonymous
GGU2	Good game, you too
JW	Jehovah's Witness
LYLC	Love you like crazy
RFC	Religious Formation Conference
NOOB	someone who is bad at (online) games
H	Hug
GR8	Great
ALADI	Asociacion Latinoamericana de Integracion;
ROC	Republic of China
HDL	High-density lipoprotein
ACS	Americans for Common Sense
TANSTAAFL	There ain't no such thing as a free lunch
PCUSA	Presbyterian Church of the USA
MICU	Medical intensive care unit
SPC	South Pacific Commission
BD	Big deal
EOD	End of day
MFI	Mad for it
RU	Roussel-Uclaf
NSCE	National Center for Science Education
K	of C Knights of Columbus
TV-TEST	Transvaginal tubal embryo stage transfer
PRO	Public relations officer
DFL	Dead *freaking* last
DV	Deo volente
UKTR	You know that's right
AGP	Association of Gay Psychologists
MIRL	Me in real life
IIRC	If I remember correctly
PDA	Population Development Association
B4N	Bye for now
ERC	Ethical Research Committee
6Y	Sexy
WAP	Whale Adoption Project
JIC	Just in case
DH	Dear (or Darling) husband
SK8	Skate
ACOOG	American College of Osteopathic Obstetricians and Gynecologists
EPC	Environmental Policy Center
AYW	As you were
PS	Postscriptum
LOLO	Lots of love
AQAP	As quick (or quiet) as possible
DL	Download
OMG	Oh my God
JW	Just wondering
LTOD	Laptop of death
RS	Runescape
EMFBI	Excuse me for butting in
FOAF	Friend of a friend
MSG	Message
AITR	Adult in the room
PDR	Physicians Desk Reference
WETSU	We eat this sh_t up
NSA	No strings attached
CRZ 	Crazy
G+	Google+
HBU	How about you?
ICAM-1	Intercellular adhesion molecule-1
VVF	Vesico-vaginal fistula
SIGMA	Sisters in Gay Ministry Associated
KIT	Keep in touch
GSA	General Services Administration
BL	Belly laugh
WLDF	Women's Legal Defense Fund
PSP	Playstation Portable
PPL	People
DOE	Daughter of Eve
CUSA	Cavitron ultrasonic surgical aspirator
CDA	Catholic Daughters of America
NCFA	National Committee for Adoption
EVO	Evolution
WHCF	White House Conference on Families
LAES	Latin American Economic System
AFMCH	American Foundation for Maternal and Child Health
A&A	Amniocentesis and abortion
EKG	Electrocardiogram
YOLO	You only live once
GTC	Gay Teachers Coalition
NEP	New Economic Policy
DEEZ NUTZ	A phrase used in online chat to annoy or frustrate those involved in the conversation.
DD	Dear (or Darling) daughter
AYTMTB	And you're telling me this because
AMOS	Assumptions are the mother of all screwups
FRC	Family Research Council
PO	Post office
RIP	Requiescat in pace
OPANAL	Organismo para la Proscripcion de las Armas Nucleares en la 
CD	Congressional district
IEA	International Energy Agency
NLSY	National Longitudinal Survey of Youth
IH2F	I have to fart
ACW	Action for World Community
4	Short for for in SMS
ABA	American Bar Association
URW	You are welcome
OMG	Oh my God
MM	Moral Majority
IMF	International Monetary Fund
IPPF	International Planned Parenthood Federation
CURE	Citizens United Resisting Euthanasia
IYO	In your opinion
FBC	Facebook chat
CU	Consumer's Union
MDIAC	My Dad is a cop
CE	[International Society of] Christian Endeavor
OB	Oh brother
Ph.D.	Philosophiae doctor
AGA	Alliance of Gay Artists
TAM	Tomorro a.m.
SAC	State Advisory Committee
NARHC	National Association of Reproductive Health Centers
UDM	U (You) da (the) man
STR8	Straight
PO	Post office
GRL	Girl
BF	Boyfriend
OFM	Order of Friars Minor
BDN	Big darn number
NCCB	National Council of Catholic Bishops
G2TU	Got to tell u (you)
IDK	I don't know
QFI	Quoted for idiocy
ICASC	International Contraception, Abortion, and Sterilization Campaign
WAM	Wait a minute
IGP	I got to (go) pee
PECAM	Platelet endothelial cell adhesion molecule
LTNS	Long time no see
GOI	Get over it
PMSL	Pee myself laughing
AMEN	AIDS in Multi-Ethnic Neighborhoods Study
CETA	Comprehensive Employment and Training Act
ICEA	International Childbirth Education Association
SOL	Sooner or later
IWIAM	Idiot wrapped in a moron
PAW	Parents are watching
FCF	Free Congress Foundation
HD	Huntington's disease
WTO	World Tourism Organization
DM	Dungeon Master
AANS	American Academy of Neurological Surgeons
S2S	Sorry to say
VGG	Very good game
FBOW	For better or worse
MPA	Medroxyprogesterone acetate
AFAM	Ancient Free and Accepted Masons
AAA	Americans Against Abortion
NBWHP	National Black Women's Health Project
GI	Government issue
EOL	End of lecture
ITU	International Telecommunication Union
FBF	Facebook friend
USSR/EE	USSR/Eastern Europe
WUW	What u (you) want?
PSHA	Public Service Health Act
OC	Order of Cistercians
NOYB	None of your business
2	to in SMS
ASLM	American Society of Law and Medicine
PSR	Physicians for Social Responsibility
CFC	Chlorofluourocarbons
SOP	Standard operating procedure
AIM	Accuracy in Media
BF2	Battlefield 2
HALP	Help (Discord)
MSW	Master of Social Work
ATSITS	All the stars in the sky
OGC	Office of General Council
POT	potion
MAIDS	Murine [mouse] Acquired Immune Deficiency Syndrome
WHAM	Women's Health Action Mobilization
IF	Intellectual Freedom
EWI	Emailing while intoxicated
AO	Anarchy Online
DTTD	Don't touch that dial
CYO	See you online
AOTA	All of the above
20	location
KB	Keyboard
MNC	Mother nature calls
LH6	Lets have sex
D/L	Download
AIAMU	And I am a money's uncle
WIU	Wrap it up
GTRM	Going to read mail 
LNT	lost in translation
NAOP	National Association for Optional Parenthood
IAAA	I am an accountant
LTD	Living the dream
IFA	International Fertility Association
ETO	Estimated time of ovulation
AAHS	Americans Against Human Suffering
QTPI	Cutie pie
2M2H	Too much to handle
TFS	Thanks for sharing
AFFA	Angels Forever, Forever Angels
AHEA	American Home Economics Association
IPS	Institute for Policy Studies
VM	Voice mail
S2R	Send to receive (meaning send me your picture to get mine)
GG	Brother (Mandarin Chinese txt msgs)
VP	Vice President
COYOTE	Cast Off Your Old Tired Ethics
AAF	As a matter of fact
CARE	Counseling for Abortion-Related Experiences
DC	Disconnect
POC	Prisoners of conscience
DSP	Daughters of St. Paul
NFS	Need for Speed
UAW	United Auto, Aircraft, and Agricultural Implements Workers of America
LC	Library of Congress
SMAZED	Smoky haze (marijuana stoned)
AITR	Adult in the room
ISO	International Organization for Standardization
URSKTM	You are so kind to me
SMSA	Standard Metropolitan Statistical Area
UNCRTN	Uncertain
SB	Senate Bill
GH	Good hand
CYO	Catholic Youth Organization
SAS	Sisters Against Sexism
TTAPS	Toon, Turco, Ackerman, Pollack, and Sagan
NFL	National Federation for Life
Ph.D.	Philosophiae doctor
CCL	Couple to Couple League
MTCR	Missile Technology Control Regime
CP	Colombo Plan
NCCL	National Committee of Catholic Laymen
SOUL	Save Our Unwanted Life
WU	What's up?
OOTD	One of these days
IOM	International Organization for Migration
YD	Yesterday
LAV	Lymphadenopathy Virus
PAPOC	Parents Alliance to Protect Our Children
LD	Long distance
FFLA	Feminists for Life of America
JK (J/K)	Just kidding
OO	Over and out
TYS	Told you so
JSD	Doctor of Juristic Science
CPE	Council on Population and Environment
WATS	Wide Area Telephone System
UOK	(Are) You ok?
TAU	Thinking about u (you)
WCF	Women's Campaign Fund
DV	Douay Version
SAT	Scholastic Aptitude Test
OT	Occupational therapy
CMGR	Community manager
NM	Nice meld
e.g.	Exempli gratia
M8	Mate
GnRHa	Gonadotrophin-releasing-hormone analogue
HHIS	Head hanging in shame
HB	Hurry back
EOD	End of discussion
NSF	National Science Foundation
UNCRTN	Uncertain
DDC	Dewey Decimal Classification
UFN	Until further notice
HLS	Human Life Statute
FOI	Freedom of Information [Act]
CCL	Couple to Couple League
BBC	British Broadcasting Corporation
UDEAC	Union Douaniere et Economique de l'Afrique Centrale
LBS	Laughing, but serious
DS	Dear (or Darling) son
OG	Original gangster
NCFPI	National Clearinghouse for Family Planning Information
LLGB	Love, later, God bless
PLAN	Plan Loving Adoption Now
LARFPC	Los Angeles Regional Family Planning Council
MTF	More to follow
FACP	Fellow of the American College of Physicians
BIO	I'm going to the bathroom (or) Bathroom break
AZN	Asian
YR	Yeah right
GALA	Gay and Lesbian Alliance
BFF	Best friends forever
AFSCME	American Federation of State, County, and Municipal Employees
T.O.P.	[Dominican] Third Order of Penance
ALS	Amyotrophic lateral sclerosis
GB	Gigabyte
USAID	United States Agency for International Development
NT	New Testament
WTM	Who's the man?
JW	Jehovah's Witness
BB	Be back
PTO	Paid time off
NVR	Never
SRA	Science Research Associates
PSA	Public service announcement
ACGME	Accreditation Council for Graduate Medical Education
HOW	Happiness of Womanhood
CLK	Click
OCarm	Order of Carmelites
NAF	National Abortion Federation
DPS	Damage per second
BR	Best regards
B-DAY	Birthday
DD	Doctor of Divinity
ET	Embryo transfer
PPAF	Planned Parenthood Action Fund
SITD	Still in the dark
LLB	Bachelor of Law
SWAG	Scientific wild *a* guess
NMA	National Medical Association
P2P	Peer to peer
KMA	Kiss my *a*
CP	Chat post (or continue in IM)
ZH	Sleeping Hour
NOEL	National Organization of Episcopalians for Life
ACD	ALT / CONTROL / DELETE
NSFL	Not safe for life
SIMYC	Sorry I missed your call
BIH	Burn in hell
EIB	European Investment Bank
YTTL	You take too long
MIA	Missing in action
GT	Good try
ILYSM	I love you so much
ABMS	American Board of Medical Specialties
DC	Developed country
LYLC	Love you like crazy
H8TTU	Hate to be you
CYEP	Close your eyes partner
DWM	Divorced white male
ESA	European Space Agency
PISS	Put in some sugar
CLW	Council for a Livable World
PP	Planned Parenthood
SOS	Son of Sam
BDEAC	Banque de Developpment des Etats de l'Afrique Centrale
ATSL	Along the same line (or lines)
BIF	Before I forget
SMP	Social Marketing Project
W@	What?
POV	Point of view
SIT	Stay in touch
AEI	American Enterprise Institute
FFA	Free for all
AGI	agility
IHM	[Servants of the] Immaculate Heart of Mary
CALC	Clergy & Laity Concerned
F	[Degrees] Fahrenheit
CTC	Care to chat?
OTTOMH	Off the top of my head
JCAH	Joint Commission on the Accreditation of Hospitals
CTC	Care to chat?
BL	Belly laugh
OMFG	Oh my *freaking* God
KMK	Kiss my keister
DF	Don't fart
WKD	Weekend
Xn	Christian
FCA	Fellowship of Christian Athletes
GL2U	Good luck to you
KK	Okay, Okay!
ACL	American Collegians for Life
LTOD	Laptop of death
ROFLMAO	Rolling on the floor, laughing my *butt* off
DEIS	Draft environmental impact statement
IHNI	I have no idea
ASA	American Sociological Association
ICEM	Intergovernmental Committee for European Migration
PEACE	People Expressing a Concern for Everyone
ATM	At the moment
SA	Salvation Army
AIDS	Acquired Immune Deficiency Syndrome
NASSP	National Association of Secondary School Principals
MD	Medical doctor
PDW	People's Daily World Magazine
PATH	Post-Abortion Trauma Healing
STP	Standard temperature and pressure
BT	Between technologies
PUG	Pick up group
IDGAF	I don't give a *freak*
EDT	Eastern daylight time
CERN	Conseil Europeen pour la Recherche Nucleaire
NLF	National Liberation Front
OB	Oh baby
WTS	Want to sell?
<3	broken heart
WEBO	Webopedia
GMV	Got my vote
TA	Thanks a lot
ARC	Archive (compressed files)
LNMP	Last normal menstrual period
CIA	Central Intelligence Agency
NBFO	National Black Feminists Organization
RCP	Revolutionary Communist Party [of the U.S.]
GMTA	Great minds think alike
S'OK	It' (s) okay (ok)
L2G	(would) Love to go
ILUM	I love you man
IAAD	I am a doctor
RIP	Requiescat in pace
AAR	At any rate
AAUW	American Association of University Women
ILY	I love you
SWAK	Sent (or sealed) with a kiss
X!	a typical woman
ARG	Argument
ACPT	Accept (e-mail, Government)
DGT	Don't go there
NPC	Non-playing character
APA	American Psychiatric Association
BOLO	Be on the look out
Feelsbadman	A social meme that means to feel negative.
WAYF	Where are you from?
CCPA	Catholics for Christian Political Action
TPTB	The powers that be
G2R	Got to run
APP	Application
SDC	Social Development Center
CLC	Campaign Life Coalition
DGA	Don't go anywhere
OB	Oh baby
LAS	League of Arab States
CWYL	Chat with you later
BIOYN	Blow it out your nose
DTTD	Don't touch that dial
XLR8	faster or going faster
CSER	Committee for the Scientific Examination of Religion
CWOT	Complete waste of time
SDS	Students for a Democratic Society
RCA	Reformed Church of America
BAG	Busting a gut
NAZI	Nationalen Socialisten
PPIH	Population Planning and International Health
ICM	Intergovernmental Committee for Migration
IME	Institute of Medical Ethics
CAC	Christian Action Council
SRY	Sorry
WCC	World Council of Churches
NAAF	National Association for Abortion Facilities
MB	Megabyte
OT	Ovum transfer
ALI	American Liberties Institute
PLS	Please
PC	Personal computer
CIS	Center for Inter-American Security
YMCA	Young Men's Christian Association
NTS	Note to self
PC	Population Communication
BAO	Be aware of
CSG	Chuckle, snicker, grin
AASECT	American Association of Sex Educators, Counselors and Therapists
WOOMB	World Organization of the Ovulation Method Billings
URA*	You are a star
NIFOC	Naked in front of computer
DSM	Diagnostic and Statistical Manual
E2EG	Ear to ear grin
CRASH	Center for Reproductive and Sexual Health
NR	Nice roll
DTS	Don't think so
PRL	Prolactin
AAF	As a friend
AYSOS	Are you stupid or something?
l33t	Leet, meaning 'elite'
CJR	Citizens for Judicial Restraint
D&E	Dilatation and evacuation
BTW	By the way 
CUL	Catholics United for Life
CRAFT	Can't remember a *freaking* thing
VWP	Very well played
WILPF	Women's International League for Peace and Freedom
DNC	Democratic National Committee
OSA	Order of St. Augustine
YBIC	Your brother in Christ
NWM	New Ways Ministry
FART	Floor Assistance Rescue Team
NAM	New age movement
HP	Hit points / Health points
FWIW	For what it's worth
EOM	End of message
WU	What's up?
IF	I farted
SPARTECA	South Pacific Regional Trade and Economic Cooperation Agreement
FY	Fiscal year
JS&A	John Short & Associates, Inc.
RTMS	Read the manual, stupid
DN	Down
BD	Big deal
ALI	American Law Institute
GDR	German Democratic Republic
WH5	Who, what, when, where, why
LDC	Less-developed country
MTFBWU	May the force be with you
CUDESH	Council for Democratic and Secular Humanism
IB	I'm back
CEIP	Carnegie Endowment for National Peace
MIM	Morality in Media
SV	Soror Vitae
DM	Doesn't matter
OOH	Out of here
Clear-TV	Christian Leaders for Responsible Television
EPS	Early Pregnancy Services
EG	Evil grin
RICO	Racketeering-Influenced Corrupt Organizations Act
ITOP	Induced termination of pregnancy
FYA	For your amusement
TCOY	Take care of yourself
DAR	Daughters of the American Revolution
IIED	International Institute for Environment and Development
GCC	Gay Community Center
FPA	Family Protection Act
WFAVS	World Federation of Associations for Voluntary Sterilization
INPLAN	Integrated Population and Development Planning
WMO	World Meteorological Organization
AJC	American Jewish Congress
AYV	Are you vertical?
NSFW	Not safe for work
UFWM	You *freaking* with me?
ASLA	Age/sex/location/availability
BADEA	Banque Arabe de Developpement Economique en Afrique
ILGWU	International Ladies' Garment Workers' Union
FOMC	Falling off my chair
MD	Medical doctor
NHS	National Health Service
LOLO	Lots of love
LC-MS	Lutheran Church-Missouri Synod
JCB	Bachelor of Canon Law
AFA	American Family Association
ABOG	American Board of Obstetrics and Gynecology
AVS	Association for Voluntary Sterilization
PDR	Physicians Desk Reference
W8	Wait
ICBM	Intercontinental ballistic missile
STD	Sacrae theologiae doctor
NOAPP	National Organization on Adolescent Pregnancy and Parenting
WFP	Witness for Peace
DS	Dear (or Darling) son
4EAE	Forever and ever 
BIOYA	Blow it out your *a*
SCAW	Scientists Center for Animal Welfare
SRA	Science Research Associates
GL	Good luck
PMFJI	Pardon me for jumping in
SUYF	Shut up you fool
B-DAY	Birthday
ACTH	Adrenocorticotropic hormone
BYOP	Bring your own paint (paintball)
UNOS	United Network for Organ Sharing
ARL	Americans for Religious Liberty
AI	Amnesty International
SIGMA	Sisters in Gay Ministry Associated
MeSH	Medical subject headings
PRESH	Precious
BBT	Be back tomorrow
L8R	Later
PDA	Personal display (of) affection
4COL	For crying out loud
TBT	Throwback Thursday (Twitter slang)
BD	Bachelor of Divinity
THX	Thanks
DLBBB	Don't let (the) bed bugs bite
CSsR	Congregatio Sanctissimi Redemptoris
UF	You farted
JOICFP	Japanese Organization for International Cooperation in Family Planning, 
USMC	United States Marine Corps
AFAIC	As far as I am concerned
EEG	Electroencephalogram
GOA	Government Accounting Office
DYFI	Did you find it?
STM	Sacrae theologiae masterieus
ICU	Intensive care unit
LSC	Legal Services Corporation
LY	Love ya 
VIP	Very important person
MOSS	Member of same sex
COS	Because
ICBM	Intercontinental ballistic missile
YWHOL	Yelling woohoo out loud
PPD	Post-partum depression
ALD	Adrenoleukodystrophy
NWM	New Ways Ministry
EPS	Early Pregnancy Services
RSV	Revised standard version
HIFW	How I felt when... (Used with photo or gif)
CRE8	Create
PDA	Population Development Association
OMS	On my soul (meaning promise)
WOW	World of Warcraft
PTO	Paid time off
CSC	Congregatio Sanctae Crucis
PDQ	Pretty damn quick
AISB	As I said before
WAN2	Want to? (SMS)
KOW	Knock on wood
Xn	Christian
OSHA	Occupational Safety and Health Administration
FICCL	Frankly I couldn't care a less
PUSH	People United to Save Humanity
MYOB	Mind your own business
RMMM	Read my mail man
ScD	Doctor of Science
OERI	Office of Educational Research and Improvement
2EZ	Too easy
PA	Prothonotary apostolic
PITA	Pain in the *butt*
IHS	Indian Health Service
CERN	Conseil Europeen pour la Recherche Nucleaire
KOW	Knock on wood
TTYAFN	Talk to you awhile from now
10M	Ten man
411	information'
GLF	Gay Liberation Front
D&C	Dilatation and curettage
YD	Yesterday
NFW	Not for work
IRTLF	International Right to Life Federation
TIR	Teacher in room
TWSS	That's what she said
URC	University Research Corporation
JIC	Just in case
COB	Close of business
APCW	Adolescent Pregnancy Childwatch Project
LVM	Left voice mail
NFM	Not for me
F2F	Face to face
HHH	Hyperornithinaemia, Hyperammonaemia, and Homocitrullinuria Syndrome
PVP	Player versus player
IAAL	I am a lawyer
ADD	Address
MIC	Maternal and Infant Care
EF4T	Effort
WRUD	What are you doing?
PG	Prostaglandin
HRT	Hormone replacement therapy
QQ	Quick question
PAF	Platelet-activating factor
HLB	Human Life Bill
IVF-DS	IVF-donor sperm
DYOR	Do your own research (common stock market chat slang)
GIAR	Give it a rest
ADAD	Another day, another dollar
WP	Warsaw Pact
CFY	Calling for you
ALMA	Adoptee's Liberty Movement Association
NYA	National Youth Administration
BGCS	Boyhood Gender Conformity Scale
BBIAF	Be back in a few
TM	Transcendental meditation
AID	Artificial insemination
BCOS	Because
NANA	Not now, no need
AE	Area effect
MP	Mana points
WTFO	What the *freak* ?, over.
BF	Best friend
QT	Cutie
FHI	Family Health International
AISB	As it should be
BBN	Bye, bye now
411	information
UHGTBSM	You have got to be s#$t*ing me!
CU	See you
AFE	Americans for the Environment
IAWS	Intercollegiate Association of Women Students
MAMA	Mothers Against Minor's Abortions
n00b	Newbie
ACC	Anyone can come
SS	So sorry
DTRT	Do the right thing
CFFC	Catholics' for a Free Choice
RYB	Read your Bible 
CPA	Certified public accountant
NFPC	National Federation of Priests' Councils
CRZ 	Crazy
ACE	Alliance for Chastity Education
LLLI	La Leche League International
G7	Group of Seven
HD	Huntington's disease
PTMM	Please tell me more
OOTO	Out of the office
INV	Invite
PDA	Pregnancy Disability Act
EAB	Ethics advisory board
CPF	Committee to Protect the Family
ISTI	International Science and Technology Institute, Inc.
MERCOSUR	Mercado Comun del Cono Sur
HQ	Headquarters
PETA	People for the Ethical Treatment of Animals
VM	Voice mail
TA	Transabdominal
AAP	Always a pleasure
IK	I know
VD	Venereal disease
TFTT	Thanks for this tweet (Twitter slang)
CM	Call me
NEJM	New England Journal of Medicine
NRHRC	National Rehabilitation Hospital Research Center
NC	Nordic Council
R&D	Research and development
AKA	Also known as
OMAA	Oh, my aching *A* (butt)
DBAU	Doing business as usual
SYY	Shut your yapper
PIP	Peeing in pants (laughing hard)
BN	Bad news
IOM	International Organization for Migration
JBS	John Birch Society
USU	Usually
IMSB	I am so bored
ICAO	International Civil Aviation Organization
SYL	See you later 
APL	Adopted People for Life
NFS	Not for sale
INS	Immigration and Naturalization Service
YWHNB	Yes, we have no bananas
ICC	International Chamber of Commerce
<33	heart or love (more 3s is a bigger heart)
DGYF	Dang, girl you fine
CRBT 	Crying really big tears 
RNC	Republican National Committee
Z	Said
E2EG	Ear to ear grin
SF	Someone farted
MCC	Metropolitan Community Church
NM	Nothing much
1CE	Once
SAA	Society for Applied Anthropology
QSL	Reply 
IUSS	If you say so
IVF-DE	IVF-donor embryo
WUT	what
POS	Parent over shoulder
YWSYLS	You win some, you lose some
ABD	Already been done
UNIFEM	United Nations Development Fund for Women
HL	Half Life
DARE	Dykes Against Racism Everywhere
JT (J/T)	Just teasing
UF	You farted
88	Bye-bye (Mandarin Chinese txt msgs) 
PM	Private Message
JAM	Just a minute
RTHX	Thanks for the RT (Retweet) (Twitter slang)
AFGE	American Federation of Government Employees
RTMS	Read the manual, stupid
OH	Overheard
SOS	Secular Organization for Sobriety Societies
JACGUAR	Johns and Call Girls United Against Repression
CEAO	Communaute Economique de l'Afrique de l'Ouest
FOMCL	Falling off my chair laughing
PSOS	Parent standing over shoulder
OYO	On your own
BA	Bachelor of Arts
InCAR	International Committee Against Racism
BF	Brain fart
W8	Wait
CPG	Catholic Pharmaceutical Guild
ABM	Anti-ballistic missile
HSG	Hysterosalpingogram
MWAH	kiss (it is is the sound made when kissing through the air)
OBV	Obviously
NHS	National Health Service
FBI	Federal Bureau of Investigation
OMB	Office of Management and Budget
CLS	Critical Legal Studies
IPA	International Phonetic Alphabet
Abp	Archbishop
B2C	Business-to-consumer
SDAT	Senile Dementia, Alzheimer's Type
ESF	Economic support funds
ICAM	I couldn't agree more
PEI	Prince Edward Island
SK8	Skate
UAE	United Arab Emirates
DSS	Delayed Shock Syndrome
CHSA	Consumer Health Service of America
SEO	Search engine optimization
DUR	Do you remember?
DF	Don't fart
HSLDA	Home School Legal Defense Association
OL	Old lady
NAM	New American Movement
WETSU	We eat this sh_t up
ASHS	Association of Secular Humanist Societies
CN-M	Certified nurse-midwife
MOOS	Member of the opposite sex
DAFUQ	(What) the *Freak*?
BIS	Best in slot
NCHLA	National Committee for a Human Life Amendment
ACOOG	American College of Osteopathic Obstetricians and Gynecologists
JCAH	Joint Commission on the Accreditation of Hospitals
SOWM	Someone with me
PCM	Please call me
NP	No problem
CCA	Christian Community Association
CCCB	Canadian Conference of Catholic Bishops
OTP	On the phone
ROTC	Reserve Officers Training Corps
GFN	Gone for now
PUKS	Pick up kids (SMS)
WITP	What is the point?
NFP	Natural family planning
YHBT	You have been trolled
BITMT	But in the meantime
B	Back
PROBS	Probably
KEYME	Key me when you get in
BOOMS	Bored out of my skull
CSE	Classroom sex education system
LIFE	Life Issues in Formal Education
BORN	Bi-State Operation Rescue Network
S-T	Sympto-thermal
SDAT	Senile Dementia, Alzheimer's Type
TBA	To be announced
PACE	Post-Abortion Counseling and Education
WVSC	Water vacuum suction curettage
NCFR	National Council on Family Relations
ITT	In This Thread
GRID	Gay-Related Immune Deficiency
H	Hug
HLI	Human Life International
ADIH	Another day in hell
NC	Nordic Council
SBIA	Standing back in amazement
IWALU	I will always love you
IR	International Review
LMIRL	Lets meet in real life
CBA	Christian Booksellers Association
SK8NG	Skating
IUP	Intrauterine pregnancy
DAFUQ	(What) the *Freak*?
ZIFT	Zygote intra-fallopian transfer
POV	Privately owned vehicle (originally used to differentiate an individual's vehicle from a military vehicle)
UR2YS4ME	You are too wise for me
APA	American Psychological Association
NIROK	Not in reach of keyboard
MOM	Mothers Organized for Morality
MSG	Message
LIK	liquor
NIMH	National Institute of Mental Health
ASL	Age/sex/location
VHEMT	Voluntary Human Extinction Movement
IF	I farted
IRMC	I rest my case
IIRC	If I remember correctly
SOMY	Sick of me yet?
TMOT	Trust me on this
QALY	Quality adjusted life years
CMA	Catholics for a Moral America
AAHA	American Academy of Health Administration
DYNWUTB	Do you know what you are talking about?
Msgr	Monsignor
CMIIW	Correct me if I'm wrong
OCD	Order of Discalced Carmelites
AID	[United States] Agency for International Development
IMAO	In my arrogant opinion
CTW	Children's Television Network
SS	Saints
AIGHT	Alright
SWAG	Scientific wild *a* guess
IPAS	International Projects Assistance Services
OGC	Office of General Council
FC	Fingers crossed
EIP	Editing in progress
BFD	Big freaking deal
LHM	Lord help me
DORBS	Adorable
NAM	Nonaligned Movement
BYTM	Better you than me
RTRCTV	Retroactive (email, Government)
LC	Library of Congress
IF	I farted
YT	You there?
APC	American Parents Committee
D/L	Download
STW	Search the Web
SUL	See you later
RYB	Read your Bible 
WARN	Women of All Red Nations
PKU	Phenylketonuria
BF	Boyfriend
SYS	See you soon 
EGF	Epidermal growth factor
SMH	Shaking my head
UF	You farted
IK	I know
NARAL	National Abortion Rights Action League [formerly the National 
PA	Parents Anonymous
CM	Calendar method
YTG	You're the greatest
HEW	[United States Department of] Health, Education and Welfare
IRLF	International Right to Life Foundation
AMWA	American Medical Women's Association
FCC	Federal Council of Churches
W3	WWW (Web address)
WISP	Winning is so pleasurable
CLRCR	Catholic League for Religious and Civil Rights
VOC	Victims of Choice
RX	drugs or prescriptions
DYOR	Do your own research (common stock market chat slang)
POC	Prisoners of conscience
NEC	National Ecumenical Coalition
AFAM	Ancient Free and Accepted Masons
KOTC	Kiss on the cheek
RLY	Really
ONL	Online
WIPO	World Intellectual Property Organization
OVA	Over
AMOF	As a matter of fact
AVC	American Veterans Committee
FAM	Fertility awareness method
USCL	United States Coalition for Life
IMTM	I am the man
GNSD	Good night, sweet dreams
DUPE	Duplicate
JSI	John Snow, Inc.
TG	Thank goodness
ACDNT	Accident (e-mail, Government)
GPHW	Gay Public Health Workers
TEGWAR	The exciting game without any rules
CIDA	Canadian International Development Agency
YTB	Youth talk back
IVIG	Intravenous immunoglobulin
W/E	Whatever
ACLA	American Catholic Lawyers Association
TLK2UL8R	Talk to you later
MKAY	Mmm, okay
UCS	Union of Concerned Scientists
AYV	Are you vertical?
MOD	Modification
OC	Oral contraceptive
TLB	The Living Bank
DMPA	Depot-medroxyprogesterone acetate
TFF	Too *freaking* funny
55555	Crying your eyes out (Mandarin Chinese txt msgs)
RIP	Rest in peace
KI	Karyopyknotic index
OSF	Order of St. Francis
CPA	Center for Policy Alternatives
<33	heart or love (more 3s is a bigger heart)
FU	*Freak* you
HP	Hit points / Health points
CDL	Citizens for Decency Through Law
AAFP	American Academy of Family Physicians
WAT	What
GIGO	Garbage in, garbage out
SA	Spontaneous abortion
VSF	Very sad face
MOMBOY	Mamma's boy
NAM	New American Movement
SC	Sisters of Charity
UNAVEM	United Nations Angola Verification Mission
MS	Master of Science
ALOL	Actually laughing out loud
ERS2	Eres tz / are you (Spanish SMS)
ACE	Alliance for Chastity Education
ICM	Intergovernmental Committee for Migration
YMMV	Your mileage may vary
DOT	Damage over time
BIDS	Birth Defects Information System
HAGN	Have a good night
OH	Overheard
NEN	Norethindrone acetate
Z	Zero
MOOS	Member of the opposite sex
MSH	Management Sciences for Health
DQMOT	Don't quote me on this
TMI	Too much information
QOTD	Quote of the day
GT	Good try
PCI	Pax Christi International
USGPO	United States Government Printing Office
FFLA	Feminists for Life of America
IDK	I don't know
DGA	Don't go anywhere
NCOG	National Council of Obstetrics and Gynecology
LWOS	Laughing without smiling
RT	Roger that
WAN2TLK	Want to talk
PTO	Parent Teacher Organization
CPS	Current Population Surveys
BID	Banco Interamericano de Desarrollo
MIT	Massachusetts Institute of Technology
YCT	Your comment to?
RTBS	Reason to be single
NIB	Nordic Investment Bank
FBF	Flashback Friday
TBA	To be aborted
AOA	American Orthopsychiatric Association
EC	European Community
QFT	Quoted for truth
BOHICA	Bend over here it comes again
PITA	Pain in the *butt*
PLD	Played
BME	Based on my experience
B/G	Background (personal information request)
FBOW	For better or worse
FWM	Fine with me
BOP	bind on pickup
LHO	Laughing head off
PPU	Pending pick-up
AGA	American Genetic Association
TLB	The Living Bank
WFC	World Food Council
ECG	Electrocardiogram
CREOG	Council on Resident Education in Obstetrics and Gynecology
NSCE	National Center for Science Education
YCL	Young Communist League
IANAC	I am not a crook
IAC	In any case
JDI	Just do it
PROGGY	computer program
TMA	Take my advice
KKK	Ku Klux Klan
G2G	Got to go
AIFR	American Institute of Family Relations
EWI	Emailing while intoxicated
YCHT	You can have them
CPG	Catholic Physicians Guild
XPOST	Cross-post. A link posted to a subreddit that was already shared on a different subreddit (Reddit)
K	of C Knights of Columbus
TYFC	Thank you for charity
ADRDAA	Alzheimer's Disease and Related Disorders Association
ATP	Adenosine triphosphate
JJ (J/J)	Just joking
UR	You are / You're
ThD	Doctor of Theology
SHID	Slapping head in disgust
PLAL	Pro-Life Action Network
SD	Sweet dreams
JV	Joint venture
UCC	United Church of Christ
PRON	pornography
FC'INGO	For crying out loud
BBIAB	Be back in a bit
GIRL	Guy in real life
NEW	Network of Empowered Women
YTTL	You take too long
DM	Direct message (Twitter slang)
YRYOCC	You're running your own cuckoo clock
FAO	Food and Agricultural Organization
182	I hate you
IGP	I got to (go) pee
TSTB	The sooner, the better
POS	Parent over shoulder
B/F	Boyfriend
MOMBOY	Mamma's boy
EZ	Easy
OA	Online auctions (see more auction abbreviations)
IBM	International Business Machine
GPA	Grade-point average
ETA	Edited to add
RBAY	Right back at you
NHLA	National Hispanic Lawyers Association
UDS	Ugly domestic scene
SIG	Special Interest Group
DCL	Doctor of Canon Law
BELF	Blood Elf
EE	Engaged Encounter
LQTM	Laughing quietly to myself
VFW	Veterans of Foreign Wars
MP	Member of Parliament
ATCC	American Type [Cell] Culture Collection
TBH	To be honest
ACA	Arms Control Association
PVS	Persistent vegetative state
MR.(number)	child and his age. Mr.3 would be a 3-year old son
BOT	Be on that
SRD	Society for the Right to Die
IMPACT	Innovative Materials for Population Action
TMTH	Too much to handle
RX	Regards
AIAA	Americans for International Aid and Adoption
DHU	Dinosaur hugs (used to show support)
IF	I farted
HAWT	sexy or attractive
CCL	Conference for 'Catholic' Lesbians
NACC	North Atlantic Cooperation Council
GMA	Gay Militant Atheists
QL	Quit laughing
1NAM	One in a million
?4U	I have a question for you
GJ	Good job
GNA	Good night all
AFC	Apostolate for Family Consecration
BAE	Before anyone else
AAL	American Abolitionist League
SP1	Pregnancy-specific beta 1-glycoprotein
CISPES	Committee in Solidarity With the People of El Salvador
IBRC	Infant Bioethical Review Committee
CDI	Center for Defense Information
NUL	National Urban League
TGIF	Thank God it's Friday
BBIAS	Be back in a sec
IDDS	Institute for Defense & Disarmament Studies
FART	Floor Assistance Rescue Team
LAPD	Los Angeles Police Department
QFB	Queers fight back
VGH	Very good hand
AUSCS	Americans United for Separation of Church and State
SWALK	Sealed (or sealed) with a loving kiss
SF	Someone farted
WWYC	Write when you can
UGTBK	You've got to be kidding
WICCA	Women in Constant Creative Action
NAOP	National Association for Optional Parenthood
I2	I too (me too)
IRCAR	International Reference Center for Abortion Research
CTHU	Cracking the *heck* up
BRH	Be right here
ISO	In search of
EM	E-mail (Twitter slang)
NFM	Not for me
ASIG	And so it goes
ICAO	International Civil Aviation Organization
FUAA	Fathers United Against Abortion
COR	Coalition on Revival
GUM	Great unwashed masses
AAD	Alliance Against Defamation
LULZ	joke, or for laughs
WASP	We are Satan's people
GALAS	Great American Lesbian Art Show
CFC	Chlorofluourocarbons
WRU	Where are you?
B	Be
SNAFU	Situation normal all fouled up
ILO0	International Labor Organization
ARE	Acronym rich environment
HTH	Hope this helps
WNAAC	Women's National Abortion Action Coalition
AOM	Age of majority
YSYD	Yeah sure you do
IR	International Review
APPP	Association of Planned Parenthood Physicians
ICJ	International Court of Justice
GAO	General Accounting Office
BFN	Bye for now
GLE	Good luck everyone
SJ	Society of Jesus
OM	Oh, my
MU	Miss U (you)
WUZ	was
GFWC	General Federation of Women's Clubs
DEGT	Dear (or Darling) daughter
DMY	Don't mess yourself
L2K	Like to come
AMEND	Moms Experiencing Neonatal Death
IH2F	I have to fart
RFD	Rural free delivery
DAE	Does anyone else?
CIF	Conservation International Foundation
PEEPS	People
PSI	Population Services International
InCAR	International Committee Against Racism
TIR	Teacher in room
TP	Treponema pallidum
ACQSTN	Acquisition (e-mail, Government)
WHO	World Health Organization
FAQ	Frequently asked questions
FC	Full card
PROLLY	Probably
OCA	Orthodox Church of America
DEGT	Dear (or Darling) daughter
AF	As *Freak*
GAFC	Get a *freaking* clue
SF	Someone farted
STL	Sacrae theologiae licentiatae
RTSM	Read the stupid manual
4AO	For adults only
BSTS	Better safe than sorry
IDA	International Development Association
DES	Diethylstilbestrol
EWTN	Eternal Word Television Network
PRC	Population Resource Center
EOT	End of transmission
AEC	Atomic Energy Commission
ABT2	About to'
ACD	ALT / CONTROL / DELETE
B2B	Business-to-business
RICO	Racketeering-Influenced Corrupt Organizations Act
SUITM	See you in the morning
AFC	Apostolate for Family Consecration
WUP	What's up?
B/G	Background (personal information request)
D&E	Dilatation and evacuation
BAD	Banque Africaine de Developpement [African Development Bank 
BIS	Bank for International Settlements
XD	a devilish smile
SDS	Students for a Democratic Society
NFWS	Not for work safe
IYSS	If you say so
VEG	Very evil grin
IFGR	International Foundation for Genetic Research
IMP	Imprimatur
OTL	Out to lunch
ELI5	Explain like I'm 5
TOS	Terms of service
ADN	Any day now
ALI	American Liberties Institute
DWF	Divorced white female
NAAPC	National Association for the Advancement of Preborn Children
IBRD	International Bank for Reconstruction and Development
FOMCL	Falling off my chair laughing
TYFYC	Thank you for your comment
NWLC	National Women's Law Center
CAD	Control + Alt + Delete
KI	Karyopyknotic index
BAS	Big 'butt' smile
NAGAP	National Association of Gay Alcoholism Professionals
ASC	American Security Council
OCI	Ovum capture inhibitor
BM&Y	Between me and you
DRG	Diagnosis-related group
CTSA	Catholic Theological Society of America
ALL	American Life Lobby
CDB	Caribbean Development Bank
YYSSW	Yeah, yeah, sure, sure, whatever
TTYS	Talk to you soon
AOYP	Angel on your pillow
INTELSAT	International Telecommunications Satellite Organization
AFZ	Acronym Free Zone
FBM	Fine by me
OAPEC	Organization of Arab Petroleum Exporting Countries
ARP	Association for Retarded Persons
OHHEMMGEE	Oh My God (alternate of OMG)
AHA	American Humane Association
NPC	Non-playing character
NALOPKT	Not a lot of people know that
ATEOTD	At the end of the day
GAS	Got a second?
TVC	Traditional Values Coalition
WGACA	What do you think?
ROK	Republic of Korea
B&	Banned
HIRE	Hooking is Respectable Employment
NICA	National Interfaith Coalition on Aging
GOP	Grand Old Party
CMON	Come on
NRL-PAC	National Right to Life Political Action Committee
PTIYPASI	Put that in your pipe and smoke it
DGAF	Don't give a *freak*
PHS	[United States] Public Health Service
SMP	Social Marketing Project
TNT	Til next time
GALAS	Great American Lesbian Art Show
Y2K	You're too kind
RW	Renaissance Women
GS	Good split
GGOH	Gotta Get Outa Here
TTFN	Ta ta for now
BPLM	Big person little mind
ACPT	Accept (e-mail, Government)
CFFC	Catholics' for a Free Choice
7K	Sick
OATUS	On a totally unrelated subject
NADT	Not a darn thing
AIR	As I remember
SACU	Southern African Customs Union
TFR	Total fertility rate
KEWL	Cool
*s*	smile  
CLC	Clergy and Laity Concerned
FWYW	Fart when you want
MPH	Master of Public Health
SCUM	Society for Cutting Up Men
LEMENO	Let me know
AEU	American Ethical Union
LAPAC	Life Amendment Political Action Committee
NM	Nice meld
LULT	Love you long time
P2P	Parent to parent
HAWT	Have a wonderful day (out-dated, see next in list)
CSOW	Commission on the Status of Women
DHS	Demographic and Health Surveys
LORCS	League of Red Cross and Red Crescent Societies
AANFP	American Academy of Natural Family Planning
TIPPS	Technical Information Population for the Private Sector
MS	Multiple sclerosis
NACHO	North American Conference of Homophile Organizations
BSF	But seriously folks
YHBW	You have been warned
HOPING	Helping in Normal Grieving
CLC	Campaign Life Coalition
PCM	Please call me
YCL	Young Communist League
IHNI	I have no idea
Q	Queue
CGD	Chronic granulomatous disease
NFPRHA	National Family Planning and Reproductive Health Association
AsDB	Asian Development Bank
NIEO	New International Economic Order
TALL	Teen American Life League
SLAP	Sounds like a plan
DITYID	Did I tell you I'm distressed?
BCFA	Birth Control Federation of America
DV8	Deviate
E1	Everyone
ATSITS	All the stars in the sky
OM	Ovulation method
HV	Humanae Vitae
DOE	Daughter of Eve
SJR	Senate Joint Resolution
QSO	Conversation
CEP	Council on Economic Priorities
SPF	South Pacific Forum
HMG	Human menopausal gonadotrophin
HIFW	How I felt when... (Used with photo or gif)
HCS	Human chorionic somatomammotropin
k/b	Keyboard
*w*	wink 
BSTS	Better safe than sorry
UNESCO	United Nations Educational, Scientific, and Cultural Organization
SPUC	Society for the Protection of the Unborn Child
YT	YouTube
GEA	Gay Educators Association
BLNT	Better luck next time
4NR	Foreigner 
ACT-UP	AIDS Coalition to Unleash Power
BOHICA	Bend over here it comes again!
LBAY	Laughing back at you
NAWL	National Association of Women Lawyers
BTA	But then again
RL	Real life
MSI	Marie Stopes International
WKD	Weekend
AIM	American Indian Movement
Feelsbatman	A social meme taking feelsbadman to the extreme. This references the DC super hero Batmanbecause he witnessed the murder of his parents.
AAS	American Association of Suicidology
BITMT	But in the meantime
HALP	Help (Discord)
PAC	Population Action Council
CARAL	California Abortion Rights Action League
OTB	Off to bed
TBD	To be determined
GOBs	Good old boys
WFC	World Food Council
BCO	Big crush on
SUX	Meanings sucks or it sucks
EMBAR	Embarassing
WENCH	Women with Enough Nerve to Create Havoc
HAGN	Have a good night
ICRC	International Committee of the Red Cross
CNS	Committee for National Security
IRC	Interchange Resource Network
ZACE	Zoapatle aqueous crude extract
YCMU	You crack me up
DH	Dear (or Darling) husband
M$	Microsoft
IA8	I already ate
BOT	Back on topic
ELISA	Enzyme-linked immunosorbent assay
HSA	Health Systems Agencies
BS	Bachelor of Science
KOC	Kiss on cheek
CX	Correction
QIK	Quick
QOL	Quality of life
CX	Correction
FBI	Federal Bureau of Investigation
ADDY	Address
PRON	pornography
RW	Real world
SB	Should be
IRS	Internal Revenue Service
S4L	Spam for life
TOY	Thinking of you
GFN	Gone for now
XD	really hard laugh (where D is a smiley mouth)
ICRC	International Committee of the Red Cross
NFD	National Federation for Decency
CPGAF	Committee on Population Growth and the American Family
PP5	Placental protein 5
PRO	Parents' Rights Organization
GOMB	Get off my back
PYT	Pretty young thing
UR2YS4ME	You are too wise for me
KJV	King James Version
QFI	Quoted for irony
MRT	Modified ReTweet  (Twitter slang)
420	Lets get high
FOAF	Friend of a friend
CCREF	Conservative Caucus Research and Education Fund
MB	Mamma's boy
6Y	Sexy
UFB	Un *freaking* believable
LFM	Looking for more
TAT	Tray agglutination test
BR	Best regards
MC	Merry Christmas
TCOY	Take care of yourself
GM-CSF	Granulocyte-macrophage colony-stimulating factor
OPM	Office of Personnel Management
SDC	Social Development Center
PAW	People for the American Way
BYOD	Bring your own device
IIIO	Intel inside, idiot outside
CU	See you too
MOD	Moderator
JMO	Just my opinion
NHANES	National Health and Nutrition Examination Survey
YHBW	You have been warned
NIB	Nordic Investment Bank
FTA-Abs	Fluorescent treponemal antibody-absorption
YKW	You know what
STW	Search the Web
NFD	National Federation for Decency
NYPLC	National Youth Pro-Life Coalition
KMA	Kiss my *a*
NRDC	National Resource Defense Council
OYO	On your own
UNOSOM	United Nations Operation in Somalia
APA	American Psychiatric Association
HTLV	Human T-Cell Lymphotropic Virus
PPFC	Planned Parenthood Federation of Canada
KMT	Kiss my tushie
GTFO	Get the *freak* out
LMIRL	Lets meet in real life
NFS	National Fertility Study
GAU	Gay Academic Union
PPL	People
TYFC	Thank you for charity
SJ	Society of Jesus
GSA	Genetics Society of America
DF	Don't fart
OCSO	Order of Cistercians of the Strict Observance
STD	Sacrae theologiae doctor
NAE	National Association of Evangelicals
G	Giggle
SIS	sister
ECO	Economic Cooperation Organization
ASCAP	American Society of Composers, Authors and Publishers
NPC	National People's Congress
NGO	Non-governmental organization
QFE	Question for everyone
TTG	Time to go
C/P	Cross post
WK	Week
AWC	After awhile crocodile
HGP	Human Genome Project
EIS	Environmental impact statement
TYS	Told you so
CPF	Committee to Protect the Family
UTI	Urinary tract infection
NERPRC	New England Regional Primate Research Center
JC (J/C)	Just checking
?	I don't understand what you mean
10Q	Thank you
CALM	Custody Action for Lesbian Mothers
^URS	Up yours
CJ	Chief Justice
IWW	Industrial Workers of the World
NWCL	National Women's Coalition for Life
YT	YouTube
RYO	Roll your own
CCR	Center for Constitutional Rights
Cakeday	Birthday (Reddit)
B2W	Back to work
PST	Please send tell
TC	Take care
CSS	Counter-Strike Source
IEC	Institutional ethics committee
CAMPUS	Coalition of American Pro-Life University Students
CID	Consider it done
SPI	Sisters of Perpetual Indulgence
<3	broken heart
EAK	Eating at keyboard
WFF	Women for Faith and Family
AATB	American Association of Tissue Banks
IOOF	International Order of Odd Fellows
FACS	Fellow of the American College of Surgeons
QALY	Quality adjusted life years
SUITM	See you in the morning
MHD	Magnetohydrodynamics
CIAO	Good-bye (Italian word)
SPST	Same place, same time
DV	Douay Version
PTSD	Post-traumatic stress disorder
SC	Stay cool
SAS	Sisters Against Sexism
MISS.(number)	child and her age. Miss.3 would be a 3-year old daughter
ADIP	Another day in paradise
OURS	Organization for United Response
KB	Kick butt
KNOW	knowledge
NGU	Non-gonococcal urethritis
ANZUS	Australia-New Zealand-United States Security Treaty
AJOG	American Journal of Obstetrics and Gynecology
SRSLY	Seriously
NSG	Nuclear Suppliers Group
MBS	Mutual Broadcasting System
G-77	Group of 77
NAMBLA	North American Man-Boy Love Association
FICCL	Frankly I couldn't care a less
ARC	Archive (compressed files)
IPA	International Phonetic Alphabet
AANP	American Academy of Nurse Practitioners
OTW	Off to work
KEYA	I will key you later
FAY	*Freak* all you
ME	Medical examiner
OMGYS	Oh my gosh you suck 
ZH	Sleeping Hour
FCC	Federal Communications Commission
AVA	American Victims of Abortion
CWRR	'Catholic' Women for Reproductive Rights
FRCP	Fellow of the Royal College of Physicians, London
NN	Nicaraguan Network
ACDNT	Accident (e-mail, Government)
FBFR	FaceBook friend
MERCOSUR	Mercado Comun del Cono Sur
U-L	You will
SD	Senile dementia
FPA	Family planning associates
NTL	National Teens for Life
NINA	No Irish need apply
PLAN	Plan Loving Adoption Now
OT	Ovum transfer
TU	Thank you
OGIM	Oh God, it's Monday
GIC	Gift in crib
DFA	Development Fund for Africa
LC-WS	Lutheran Church-Wisconsin Synod
KOS	Kid over shoulder
G2CU	Good to see you
G	Grand
MGB	May God bless
USCSC	United States Civil Service Commission
TRUTH	Teens Rescuing Unborn Tiny Humans
TBA	To be aborted
MEGO	My eyes glaze over
FCOL	For crying out loud
SWAT	Special Weapons and Tactics
OECD	Organization for Economic Cooperation and Development
THNX	Thanks
ERP	Erotic Role-Play
UNTSO	United Nations Truce Supervision Organization
LDL	Low-density lipoprotein
TMB	Text me back
LSHMBH	Laugh so hard my belly hurts
IAEA	International Atomic Energy Agency
RSV	Revised standard version
MFW	My face when... (Used with photo or gif)
DIKU	Do I know you?
MB	Mamma's boy
GGP	Got to go pee
HQ	Headquarters
JLMK	Just let me know
PC	Population Communication
CAHEA	Committee on Allied Health Education and Accreditation
OEO	Office of Economic Opportunity
IYSS	If you say so
SIECUS	Sex Information and Education Council of the United States
PLO	Palestinian Liberation Organization
NLFO	National Lesbian Feminist Organization
UFN	Until further notice
SBC	School-based clinic
MPA	Master of Public Administration
SJW	Social justice warrior
BM	Basal metabolism
NAPN	National Association of Pro-Life Nurses
PST	Please send tell
FFP	Friends of Family Planning
AP	Associated Press
YHL	You have lost
@TEOTD	At the end of the day
HC	Holy Communion
CLAB	Crying like a baby
POAHF	Put on a happy face
DF	Don't fart
NCC	National Catholic Coalition
RHIP	Rank has its privileges
WYWH	Wish you were here
OR	Operation Rescue
GORK	God only really knows
QC	Quality control
*w*	wink 
GGE1	Good game, everyone
F	Fart
LHO	Laughing head off
TQ	Te quiero / I love you (Spanish SMS)
2EZ	Too easy
HIRE	Hooking is Respectable Employment
WFF	Women for Faith and Family
A/N	Author's note
DILLIGAS	Do I look like I give a sugar?
MOD	Modification
POV	Point of View [television program]
AF	April Fools
NMJC	Nothing much, just chilling
KUTGW	Keep up the good work
BBN	Bye, bye now
2MORO	Tomorrow
BDAY	Birthday
GOMER	Get out of my emergency room
CU	See you too
LOTR	Lord of The Rings
SAL	Such a laugh
FART	Floor Assistance Rescue Team
IWO	Institute for World Order
X	Kiss
420	Marijuana
ACP	American College of Physicians
UAE	United Arab Emirates
ROTFL	Rolling on the floor laughing
PRESH	Precious
GRATZ	Congratulations
CRF	Constitutional Rights Foundation
4AO	For adults only
PLU	People like us
PIC	Picture
MTFBWU	May the force be with you
O4U	Only for you
ROTFLUTS	Rolling on the floor laughing unable to speak
GRINCH	Gay Retaliation for Inexcusable Negligence and Criminal Homophobia
HL	House of Lords
NCEA	National Catholic Education Association
TMWFI	Take my word for it
EVO	Evolution
LTLWDLS	Let's twist like we did last summer
INC	incoming
AIGHT	Alright
Z	Z's are calling (meaning going to bed/sleep)
JACGUAR	Johns and Call Girls United Against Repression
FIL	Father in law
W/O	Without
LCL	League of Catholic Laymen
UPUSA	United Presbyterians USA
CHA	Catholic Health Association
B&	Banned
ICFILWU	I could fall in love with you
RVN	Republic of Viet Nam
OLL	Online love
DOM	Deo optimo maximo
ENTA	Norethindrone acetate
ADMINR	Administrator (Government)
LTL	Laparoscopic tubal ligation
DMNO	Dude Man No Offense
LOTI	Laughing on the inside
PPFA	Planned Parenthood Federation of America
2MOR	Tomorrow
IYQ	I like you
SJD	Doctor of Juridical Science
LYSM	Love you so much
CACM	Central American Common Market
C	Commonwealth
SWMBO	She who must be obeyed. Meaning wife or partner
INAL	I'm not a lawyer
CFA	Committee for Future America
AISA	Adoption Information Service Agency
NLSY	National Longitudinal Survey of Youth
NCDC	National Catholic Development Conference
CEP	Council on Environmental Quality
B9	Boss is watching
PSOS	Parent standing over shoulder
ESAD	Eat *S* and die!
BRT	Be right there
19	Zero hand
OIC	Organization of the Islamic Conference
RTL	Right to Life
GD/R	Grinning, ducking, and running
YTB	Youth talk back
MU	Miss U (you)
FACES	National Association for the Craniofacially Handicapped
IRC	Interchange Resource Network
CSOW	Commission on the Status of Women
PRO	Population Renewal Office
AFFA	Angels Forever, Forever Angels
ERP	Erotic Role-Play
GL	Good luck
UNOMOZ	United Nations Operation in Mozambique
FUTAB	Feet up, take a break
;S	Gentle warning, like Hmm? What did you say?
MEZ	mesmerize
TTAPS	Toon, Turco, Ackerman, Pollack, and Sagan
BRD	Bored
TMB	Text me back
BBA	Balanced Budget Amendment
LDL	Low-density lipoprotein
WHAM	Women's Health Action Mobilization
NMH	Not much here
CPM	Cesarian Prevention Movement
1432	I love you too
OECS	Organization of Eastern Caribbean States
CIAO	Good-bye (Italian word)
KIA	Know it all
ASM	American Society of Mammologists
CB	Crazy *b*
NVR	Never
YBS	You'll be sorry
BAO	Be aware of
IWAWO	I want a way out
NCA	National Chastity Association
APHA	American Protestant Hospital Association
CRASH	Committee Against Racism, Sexism, and Heterosexism
CSCE	Conference on Security and Cooperation in Europe
PIH	Pyridoxal isonicotinoyl hydrazone
H&K	Hugs & kisses
TMA	Take my advice
FAAK	Falling asleep at keyboard
SIDS	Sudden Infant Death Syndrome
AOE	Area of effect (online game)
ARMS	Abortion-Related Ministries
CAP	Committee for American Principles
j00r	Your
LHM	Lord help me
WITW	What in the world
TURNT	Turn up
CID	Crying in disgrace
IM	Instant message
LIMT	Laugh in my tummy
CYA	See you
NM	Never mind
ALA	American Library Association
AKA	Also known as
PCUC	People Concerned for the Unborn Child
NRN	No response/reply necessary
NSTA	National Science Teachers Association
IAO	I am out (of here)
WEU	Western European Union
NOYB	None of your business
TMB	Tweet me back (Twitter slang)
E	Enemy
NS	Nice split
PFT	Pretty *freaking* tight
VAT	Value added tax
LAES	Latin American Economic System
RTNTN	Retention (email, Government)
JLC	Juvenile Law Center
FOAD	*Freak* off and die
ITEST	Institute for Theological Encounter With Science and Technology
PEEPS	People
PCI	Population Communications International
WE	Whatever
AA	Ask about
NW	No way
NOPE	National Optimum Population Effort
ENTA	Norethindrone acetate
LDS	Latter-Day Saints
DOM	Deo optimo maximo
PUSH	People United to Save Humanity
TL	Too long
10X	Thanks
EPH	Edema/proteinuria/hypertension
ASHG	American Society of Human Genetics
NOPARH	National Office of Post-Abortion Reconciliation and Healing
GF	Girl friend
WEBO	Webopedia
EST	Eastern standard time
TLK2UL8R	Talk to you later
TUI	Turning you in
FBF	Fat boy food (e.g. pizza, burgers, fries)
ABC	Already been chewed
DBP	Defense Budget Project
DA	The
ESMP	Enhanced survival of multifetal pregnancy
H-FDAY	Happy Father's Day
INFACT	Infant Formula Coalition
MWAH	kiss (it is is the sound made when kissing through the air)
X-1-10	Exciting
WOC	Women's Ordination Conference
WIU	Wrap it up
PLO	Palestinian Liberation Organization
VN	Very nice
WDYT	What do you think?
TYT	Take your time
AMEN	AIDS in Multi-Ethnic Neighborhoods Study
CAC	Christian Action Council
NWO	No way out
XLNT	Excellent 
WASP	We Are Sexual Perverts
CRAFT	Can't remember a *freaking* thing
PLZ	Please
CR	Calendar rhythm
BOE	bind on equip
2NTE	Tonight
EAK	Eating at keyboard
EEC	Euthanasia Educational Council
UPC	United Pro-Life Council
NFW	Not for work
j00r	Your
DNR	Dinner (SMS)
TV-TEST	Transvaginal tubal embryo stage transfer
NCNW	National Council of Negro Women
NOPARH	National Office of Post-Abortion Reconciliation and Healing
URTM	You are the man
AYOR	At your own risk
THT	Think happy thoughts
COS	Because
CB	Coffee break
HLS	Human Life Statute
TSNF	That's so not fair
SD	Senile dementia
IFN	Interferon
PI	Pearl Index
DNR	Dinner (SMS)
SRY	Sorry
H8	Hate
EO	Executive Order
IH2F	I have to fart
YG	Young gentleman
MCH	[Department of] Maternal and Child Health
IRD	Institute for Resource Development, Westinghouse
OCart	Order of Carthusians
VBAC	Vaginal birth after Cesarian [section]
AGI	Alan Guttmacher Institute
P.C.	Politically correct
RCP	Revolutionary Communist Party [of the U.S.]
NWPC	National Women's Political Caucus
MWA	Modern Woodmen of America
FHI	Family Health International
2G2BT	Too good to be true
OVA	Over
H-BDAY	Happy Birthday
WYGAM	When you get a minute
CTN	Can't talk now
CM	Congregation for the Mission
GSA	Gay Students Association
RTI	Research Triangle Institute
CHAP	Child Health Assurance Program
DINK	Double-income, no kids
NDA	New drug application
ABU	All bugged up
DF	Don't fart
SOT	Short of time
CIOMS	Council for International Organizations of Medical Sciences
IYKWIM	If you know what I mean
PS	Pro-Lifers for Survival
JFGI	Just *freaking* Google it
NAS	National Association of Scholars
VIP	Very important person
VFM	Value for money
CURE	Citizens United for Responsible Education
MNSG	Mensaje (message in Spanish)
F	female
LMS	Like my status (Facebook)
FARM	Farm Animal Reform Movement
BSCS	Biological Sciences Curriculum Study
AGA	Alliance of Gay Artists
BRBB	Be right back *babe*
TMTH	Too much to handle
QTPI	Cutie pie
NAS	National Audobon Society
ABM	Anti-ballistic missile
ARHP	Association of Reproductive Health Professionals
PU	That stinks!
WHO	World Health Organization
SWL	Screaming with laughter
E1	Everyone
FART	Floor Assistance Rescue Team
SAA	Sexual Addicts Anonymous
GGU2	Good game, you too
O	Over
BRB	Be right back
VBL	Visible bra line
TOTES	Totally
NTHING	Nothing (SMS)
APHA	American Public Health Association
UW	You're welcome
SETE	Smiling Ear-to-Ear
RTWFQ	Read the whole *freaking* question
HM	His or Her Majesty
GIGO	Garbage in, garbage out
NIDA	National Institute on Drug Abuse
H-MDAY	Happy Mother's Day
CFC	Combined Federal Campaign
FSA	Family Service Association
LFG	Looking for group
LMBO	Laughing my butt off
NOEL	National Organization of Episcopalians for Life
IMS	I am sorry
SSINF	So stupid it's not funny
MR.(number)	child and his age. Mr.3 would be a 3-year old son
AF	April Fools
DIKU	Do I know you?
AISB	As I said before
APAC	All praise and credit
BBT	Be back tomorrow
STOP	Save the Oppressed People
CFA	Committee for Future America
AOH	Ancient Order of Hibernians
PLMK	Please let me know
ICFTU	International Confederation of Free Trade Unions
NIMBY	Not in my back yard
SOT	Short of time
SCLC	Southern Christian Leadership Conference
DXNRY	Dictionary
GNP	Gross national product
CUMID	See you in my dreams
NSA	No strings attached
SALT	Strategic Arms Limitation Talks
DHEW	Department of Health, Education, and Welfare
GnRH	Gonadotrophin-releasing hormone
AYTMTB	And you're telling me this because
MPS	Mucopolysaccharidoses
WAA	Women's Action Alliance
START	Strategic arms reduction treaty
TVC	Traditional Values Coalition
MCCL	Minnesota Citizens Concerned for Life
AOE	Area of effect (online game)
NAZI	Nationalen Socialisten
DTS	Don't think so
BC	Be cool
A3	Anytime, anywhere, anyplace
NOLGS	National Organization of Lesbian and Gay Scientists
JAS	Just a second
FART	Floor Assistance Rescue Team
OMDB	Over my dead body
BBL	Be back later
G2GICYAL8ER	Got to go I'll see you later
FART	Floor Assistance Rescue Team
AAP	American Academy of Pediatrics
X-1-10	Exciting
IAAD	I am a doctor
VIP	Voter identification project
VGH	Very good hand
IUB	Intrauterine occlusion body
UNDP	United Nations Development Program
VD	Venereal disease
AMU	Arab Maghreb Union
R2N2	Reproductive Rights National Network
DAD	Dads Against Discrimination
HLI	Human Life International
SFAIK	So far as I know
WE	Whatever
ANA	American Nurses Association
YGTR	You got that right
MFI	Mad for it
IYC	International Year of the Child
SDI	Strategic Defense Initiative
EC	Evangelicals Concerned
IFRP	International Fertility Research Program
SMH	Shaking my head
SorG	Straight or Gay?
ISO	In search of
JCL	Licentiate in Canon Law
UPA	Unwed Parents Anonymous
OTFL	On the floor laughing
OSM	Order of the Servants of Mary
WITCH	Witches' International Conspiracy from Hell
TAFN	That's all for now
SS	Schutzstaffel
WC	Who cares
THNQ	Thank-you (SMS)
WIBNI	Wouldn't it be nice if
GLAD	Gay and Lesbian Awareness Da
CR8	Create
CM-BBT	Cervical Mucus-Basal Body Temperature
U-L	You will
ADD	Address
NIMBY	Not in my back yard
H-MDAY	Happy Mother's Day
TAUMUALU	Thinking about you miss you always love you
ADAD	Another day, another dollar
PIRG	Public Interest Research Group
TBAG	Process of disgracing a corpse, taunting a fragged/killed player
ACCT	Agence de Cooperation Culturelle et Technique
W/END	Weekend
SLAP	Sounds like a plan
P2P	Peer to peer
PCI	Pax Christi International
HOPE	Housing Opportunities for People Everywhere
TARS	Thrombocytopenia with absent radii syndrome
DORBS	Adorable
JLC	Juvenile Law Center
AIHCA	American Indian Health Care Association
PRT	Please Retweet (Twitter slang)
CDL	Citizens for Decency Through Law
KIA	Know it all
RC	Roman Catholic
KK	Knock, knock
RUOK	Are you okay?
RYS	Read your screen 
PDA	Personal display (of) affection
SOUL	Save Our Unwanted Life
LTLWDLS	Let's twist like we did last summer
PAPP-A	Pregnancy-associated plasma protein-A
DKP	Dragon kill points
HW	Homework
PISS	Put in some sugar
ALG	American Lawyer's Guild
CHAP	Child Health Assurance Program
IC	I see
DQMOT	Don't quote me on this
GG	Good Game
UWA	United Way of America
BIP	Basic infertile pattern
M$	Microsoft
HAND	Have a nice day
GAS	Greetings and salutations
EMA	E-mail address (Twitter slang)
UNOS	United Network for Organ Sharing
AE	American Education Association
AVES	Australian Voluntary Euthanasia Society
NAF	National Abortion Federation
G2GICYAL8ER	Got to go I'll see you later
TILIS	Tell it like it is
P2P	Pay to play
CAD	Control + Alt + Delete
MM	Maryknoll Missioners
DILLIGAF	Do I look like I give a *freak*?
SIHTH	Stupidity is hard to take
LMNK	Leave my name out
NGHEF	National Gay Health Education Foundation, Inc.
TANKED	owned
RTRMT	Retirement (email, Government)
IOC	International Olympic Committee
OPR	Office of Population Research, Princeton University
AUL	Americans United for Life
TLN	The Lavender Network Magazine
IRBM	Intermediate Range Ballistic Missile
HC	Holy Communion
NMU	Not much, you?
PRO	Population Renewal Office
OSHA	Occupational Safety and Health Administration
GDR	Grinning, ducking, and running
B8	Bait (person teased or joked with, or under-aged person/teen)
AOM	Age of Mythology
AIR	As I remember
AYDY	Are you done yet?
TL;DR	Too long; didn't read
TTLY	Totally
LHSX	Lets have sex
BFG	Big  freaking grin
ST&D	Stop texting and drive
WAP	Women Against Pornography
LOOM	Loyal Order of Moose
IERA	Inclusive Equal Rights Amendment
SITD	Still in the dark
IBEC	International Bank for Economic Cooperation
BRH	Be right here
MYOB	Mind your own business
NCPAC	National Conservative Political Action Committee
COPE	Committee on Political Education
MNC	Mother nature calls
R8	Rate (SMS)
AYEC	At your earliest convenience
BOM	*b* of mine
NCGO	National Coalition of Gay Organizations
AIAMU	And I am a money's uncle
VN	Very nice
OEA	Office of Environmental Affairs
EYC	Excitable, yet calm
NSC	National Security Council
WHCA	White House Conference on Aging
GBS	Gay bowel syndrome
NCSW	National Conference on Social Welfare
TNSTAAFL	There's no such thing as a free lunch
CCA	Christian Community Association
NFP	Natural family planning
LSV	Language, sex and violence
PAU	Pan American Union
CPFH	Center for Population and Family Health, Columbia University
DC	Doctor of Chiropractic
AI	Artificial intelligence
NCC	National Council of Churches
ADIH	Another day in hell
IASR	International Academy of Sex Research
PA	Physicians assistant
CNN	Cable News Network
DL	Down low
NWCL	National Women's Coalition for Life
AMAP	As much as possible
